Orthogroup	Amphimedon_UP000007879_400682	Ephydatia_Emu_v1_prots	Human_UP000005640_9606	Niphates_augustus.hints.aa	Total
OG0000000	589	33	0	58	680
OG0000001	1	298	0	0	299
OG0000002	250	1	0	25	276
OG0000003	166	12	5	48	231
OG0000004	0	228	0	0	228
OG0000005	0	223	0	0	223
OG0000006	0	222	0	0	222
OG0000007	0	176	0	0	176
OG0000008	173	0	0	1	174
OG0000009	0	159	0	0	159
OG0000010	156	0	0	2	158
OG0000011	0	0	155	0	155
OG0000012	154	0	0	0	154
OG0000013	153	0	0	0	153
OG0000014	145	0	0	0	145
OG0000015	132	0	0	1	133
OG0000016	0	129	0	0	129
OG0000017	126	0	0	1	127
OG0000018	110	0	0	13	123
OG0000019	0	123	0	0	123
OG0000020	0	0	123	0	123
OG0000021	113	1	0	5	119
OG0000022	105	4	0	9	118
OG0000023	91	2	2	22	117
OG0000024	0	117	0	0	117
OG0000025	106	0	0	9	115
OG0000026	0	115	0	0	115
OG0000027	0	114	0	0	114
OG0000028	0	113	0	0	113
OG0000029	111	0	0	1	112
OG0000030	103	0	0	0	103
OG0000031	49	25	1	23	98
OG0000032	22	61	0	14	97
OG0000033	25	58	1	11	95
OG0000034	0	94	0	0	94
OG0000035	89	3	0	1	93
OG0000036	45	30	0	15	90
OG0000037	88	0	0	2	90
OG0000038	0	90	0	0	90
OG0000039	0	0	89	0	89
OG0000040	88	0	0	0	88
OG0000041	61	3	0	24	88
OG0000042	15	39	0	34	88
OG0000043	0	88	0	0	88
OG0000044	80	3	0	2	85
OG0000045	83	0	0	2	85
OG0000046	1	0	0	83	84
OG0000047	1	80	0	1	82
OG0000048	0	81	0	0	81
OG0000049	0	80	0	0	80
OG0000050	0	79	0	0	79
OG0000051	0	78	0	0	78
OG0000052	76	0	0	1	77
OG0000053	0	77	0	0	77
OG0000054	76	0	0	0	76
OG0000055	0	75	1	0	76
OG0000056	64	2	0	8	74
OG0000057	70	0	0	3	73
OG0000058	2	1	1	69	73
OG0000059	70	0	0	1	71
OG0000060	0	71	0	0	71
OG0000061	0	0	70	0	70
OG0000062	68	0	0	1	69
OG0000063	0	69	0	0	69
OG0000064	66	0	0	2	68
OG0000065	41	0	0	26	67
OG0000066	66	0	0	0	66
OG0000067	65	0	0	0	65
OG0000068	2	63	0	0	65
OG0000069	63	0	0	0	63
OG0000070	60	0	0	2	62
OG0000071	32	1	1	28	62
OG0000072	0	0	62	0	62
OG0000073	0	0	62	0	62
OG0000074	61	0	0	0	61
OG0000075	60	0	0	0	60
OG0000076	58	0	0	2	60
OG0000077	0	60	0	0	60
OG0000078	0	60	0	0	60
OG0000079	58	0	0	1	59
OG0000080	38	15	4	2	59
OG0000081	0	59	0	0	59
OG0000082	58	0	0	0	58
OG0000083	8	42	0	8	58
OG0000084	4	49	0	5	58
OG0000085	0	58	0	0	58
OG0000086	0	0	58	0	58
OG0000087	55	0	0	2	57
OG0000088	1	56	0	0	57
OG0000089	0	57	0	0	57
OG0000090	0	57	0	0	57
OG0000091	56	0	0	0	56
OG0000092	54	1	0	1	56
OG0000093	54	0	0	1	55
OG0000094	0	55	0	0	55
OG0000095	17	0	0	37	54
OG0000096	24	17	3	10	54
OG0000097	0	54	0	0	54
OG0000098	0	54	0	0	54
OG0000099	48	1	1	3	53
OG0000100	52	0	0	1	53
OG0000101	0	53	0	0	53
OG0000102	0	0	53	0	53
OG0000103	52	0	0	0	52
OG0000104	37	3	1	11	52
OG0000105	47	1	0	3	51
OG0000106	0	51	0	0	51
OG0000107	0	0	51	0	51
OG0000108	21	1	9	19	50
OG0000109	20	2	3	25	50
OG0000110	47	0	0	3	50
OG0000111	50	0	0	0	50
OG0000112	0	50	0	0	50
OG0000113	40	2	0	7	49
OG0000114	48	0	0	1	49
OG0000115	44	0	0	5	49
OG0000116	0	0	49	0	49
OG0000117	0	0	0	49	49
OG0000118	1	46	0	1	48
OG0000119	0	48	0	0	48
OG0000120	0	48	0	0	48
OG0000121	0	48	0	0	48
OG0000122	0	46	2	0	48
OG0000123	47	0	0	0	47
OG0000124	30	0	0	17	47
OG0000125	47	0	0	0	47
OG0000126	0	47	0	0	47
OG0000127	0	47	0	0	47
OG0000128	45	0	0	1	46
OG0000129	32	1	5	8	46
OG0000130	25	17	0	4	46
OG0000131	0	46	0	0	46
OG0000132	0	46	0	0	46
OG0000133	0	0	46	0	46
OG0000134	45	0	0	0	45
OG0000135	45	0	0	0	45
OG0000136	45	0	0	0	45
OG0000137	10	22	4	9	45
OG0000138	1	44	0	0	45
OG0000139	0	45	0	0	45
OG0000140	0	45	0	0	45
OG0000141	0	44	1	0	45
OG0000142	0	0	45	0	45
OG0000143	0	0	45	0	45
OG0000144	0	0	45	0	45
OG0000145	0	0	0	45	45
OG0000146	42	0	0	2	44
OG0000147	3	22	17	2	44
OG0000148	0	44	0	0	44
OG0000149	0	44	0	0	44
OG0000150	0	44	0	0	44
OG0000151	0	44	0	0	44
OG0000152	0	0	44	0	44
OG0000153	41	0	0	2	43
OG0000154	42	0	0	1	43
OG0000155	42	0	0	1	43
OG0000156	7	14	0	22	43
OG0000157	0	43	0	0	43
OG0000158	0	0	0	43	43
OG0000159	42	0	0	0	42
OG0000160	17	24	0	1	42
OG0000161	0	42	0	0	42
OG0000162	0	42	0	0	42
OG0000163	0	0	42	0	42
OG0000164	3	23	13	2	41
OG0000165	0	41	0	0	41
OG0000166	0	41	0	0	41
OG0000167	0	0	41	0	41
OG0000168	15	18	1	6	40
OG0000169	39	0	0	1	40
OG0000170	39	0	0	1	40
OG0000171	40	0	0	0	40
OG0000172	2	0	0	38	40
OG0000173	9	22	0	9	40
OG0000174	3	1	0	36	40
OG0000175	4	22	8	6	40
OG0000176	0	40	0	0	40
OG0000177	0	40	0	0	40
OG0000178	31	0	0	8	39
OG0000179	39	0	0	0	39
OG0000180	35	0	0	4	39
OG0000181	26	0	0	13	39
OG0000182	39	0	0	0	39
OG0000183	5	17	0	17	39
OG0000184	4	34	0	1	39
OG0000185	7	23	0	9	39
OG0000186	0	39	0	0	39
OG0000187	0	39	0	0	39
OG0000188	0	39	0	0	39
OG0000189	0	39	0	0	39
OG0000190	0	39	0	0	39
OG0000191	33	3	0	2	38
OG0000192	38	0	0	0	38
OG0000193	37	0	0	1	38
OG0000194	15	11	0	12	38
OG0000195	36	0	0	2	38
OG0000196	0	38	0	0	38
OG0000197	0	38	0	0	38
OG0000198	0	38	0	0	38
OG0000199	0	0	38	0	38
OG0000200	0	0	38	0	38
OG0000201	0	0	38	0	38
OG0000202	34	0	0	3	37
OG0000203	13	16	2	6	37
OG0000204	0	37	0	0	37
OG0000205	0	37	0	0	37
OG0000206	0	37	0	0	37
OG0000207	0	37	0	0	37
OG0000208	0	37	0	0	37
OG0000209	0	0	37	0	37
OG0000210	0	0	37	0	37
OG0000211	36	0	0	0	36
OG0000212	34	0	0	2	36
OG0000213	16	1	0	19	36
OG0000214	10	9	3	14	36
OG0000215	1	34	1	0	36
OG0000216	0	36	0	0	36
OG0000217	0	36	0	0	36
OG0000218	0	36	0	0	36
OG0000219	0	36	0	0	36
OG0000220	0	36	0	0	36
OG0000221	0	35	1	0	36
OG0000222	0	0	36	0	36
OG0000223	31	0	0	4	35
OG0000224	34	0	0	1	35
OG0000225	35	0	0	0	35
OG0000226	12	16	0	7	35
OG0000227	21	13	0	1	35
OG0000228	11	17	1	6	35
OG0000229	0	35	0	0	35
OG0000230	0	35	0	0	35
OG0000231	0	35	0	0	35
OG0000232	0	34	1	0	35
OG0000233	0	35	0	0	35
OG0000234	0	35	0	0	35
OG0000235	0	35	0	0	35
OG0000236	0	0	35	0	35
OG0000237	0	0	35	0	35
OG0000238	27	1	0	6	34
OG0000239	29	1	1	3	34
OG0000240	12	8	1	13	34
OG0000241	34	0	0	0	34
OG0000242	2	16	12	4	34
OG0000243	0	33	1	0	34
OG0000244	0	34	0	0	34
OG0000245	0	34	0	0	34
OG0000246	0	34	0	0	34
OG0000247	0	34	0	0	34
OG0000248	0	0	34	0	34
OG0000249	0	0	34	0	34
OG0000250	0	0	34	0	34
OG0000251	33	0	0	0	33
OG0000252	5	26	0	2	33
OG0000253	0	33	0	0	33
OG0000254	0	33	0	0	33
OG0000255	0	33	0	0	33
OG0000256	0	33	0	0	33
OG0000257	0	0	33	0	33
OG0000258	25	0	0	7	32
OG0000259	23	6	0	3	32
OG0000260	25	0	0	7	32
OG0000261	32	0	0	0	32
OG0000262	28	0	1	3	32
OG0000263	12	9	1	10	32
OG0000264	10	20	0	2	32
OG0000265	0	32	0	0	32
OG0000266	0	32	0	0	32
OG0000267	0	31	0	1	32
OG0000268	0	0	32	0	32
OG0000269	31	0	0	0	31
OG0000270	30	0	0	1	31
OG0000271	31	0	0	0	31
OG0000272	29	0	0	2	31
OG0000273	31	0	0	0	31
OG0000274	6	17	3	5	31
OG0000275	1	30	0	0	31
OG0000276	0	31	0	0	31
OG0000277	0	31	0	0	31
OG0000278	0	31	0	0	31
OG0000279	0	31	0	0	31
OG0000280	0	31	0	0	31
OG0000281	0	31	0	0	31
OG0000282	0	31	0	0	31
OG0000283	0	31	0	0	31
OG0000284	0	31	0	0	31
OG0000285	0	31	0	0	31
OG0000286	0	0	31	0	31
OG0000287	0	0	0	31	31
OG0000288	30	0	0	0	30
OG0000289	10	0	0	20	30
OG0000290	30	0	0	0	30
OG0000291	12	13	1	4	30
OG0000292	20	5	0	5	30
OG0000293	28	2	0	0	30
OG0000294	21	1	0	8	30
OG0000295	28	0	1	1	30
OG0000296	30	0	0	0	30
OG0000297	5	14	3	8	30
OG0000298	23	0	1	6	30
OG0000299	24	0	0	6	30
OG0000300	27	3	0	0	30
OG0000301	1	29	0	0	30
OG0000302	1	23	1	5	30
OG0000303	0	30	0	0	30
OG0000304	0	30	0	0	30
OG0000305	0	30	0	0	30
OG0000306	0	30	0	0	30
OG0000307	0	30	0	0	30
OG0000308	0	30	0	0	30
OG0000309	0	30	0	0	30
OG0000310	0	30	0	0	30
OG0000311	29	0	0	0	29
OG0000312	29	0	0	0	29
OG0000313	26	2	0	1	29
OG0000314	29	0	0	0	29
OG0000315	29	0	0	0	29
OG0000316	29	0	0	0	29
OG0000317	26	1	1	1	29
OG0000318	8	15	1	5	29
OG0000319	9	13	2	5	29
OG0000320	1	28	0	0	29
OG0000321	1	28	0	0	29
OG0000322	1	0	0	28	29
OG0000323	0	29	0	0	29
OG0000324	0	29	0	0	29
OG0000325	0	29	0	0	29
OG0000326	0	29	0	0	29
OG0000327	0	29	0	0	29
OG0000328	0	29	0	0	29
OG0000329	0	0	29	0	29
OG0000330	0	0	29	0	29
OG0000331	0	0	29	0	29
OG0000332	0	0	29	0	29
OG0000333	0	0	0	29	29
OG0000334	28	0	0	0	28
OG0000335	26	2	0	0	28
OG0000336	16	0	3	9	28
OG0000337	28	0	0	0	28
OG0000338	28	0	0	0	28
OG0000339	18	1	0	9	28
OG0000340	3	20	0	5	28
OG0000341	9	10	1	8	28
OG0000342	0	28	0	0	28
OG0000343	0	28	0	0	28
OG0000344	0	28	0	0	28
OG0000345	0	28	0	0	28
OG0000346	0	28	0	0	28
OG0000347	0	28	0	0	28
OG0000348	0	28	0	0	28
OG0000349	0	28	0	0	28
OG0000350	0	28	0	0	28
OG0000351	0	1	0	27	28
OG0000352	27	0	0	0	27
OG0000353	27	0	0	0	27
OG0000354	26	0	0	1	27
OG0000355	25	2	0	0	27
OG0000356	5	14	1	7	27
OG0000357	27	0	0	0	27
OG0000358	8	3	2	14	27
OG0000359	7	0	0	20	27
OG0000360	1	26	0	0	27
OG0000361	1	0	0	26	27
OG0000362	1	25	0	1	27
OG0000363	4	20	1	2	27
OG0000364	0	27	0	0	27
OG0000365	0	27	0	0	27
OG0000366	0	27	0	0	27
OG0000367	0	27	0	0	27
OG0000368	0	0	27	0	27
OG0000369	0	0	27	0	27
OG0000370	0	0	27	0	27
OG0000371	25	0	0	1	26
OG0000372	19	0	0	7	26
OG0000373	26	0	0	0	26
OG0000374	7	15	0	4	26
OG0000375	17	0	0	9	26
OG0000376	25	0	0	1	26
OG0000377	16	0	1	9	26
OG0000378	25	1	0	0	26
OG0000379	26	0	0	0	26
OG0000380	26	0	0	0	26
OG0000381	11	0	1	14	26
OG0000382	10	11	2	3	26
OG0000383	10	4	0	12	26
OG0000384	26	0	0	0	26
OG0000385	19	1	1	5	26
OG0000386	3	14	4	5	26
OG0000387	1	22	0	3	26
OG0000388	1	23	1	1	26
OG0000389	0	26	0	0	26
OG0000390	0	25	0	1	26
OG0000391	0	26	0	0	26
OG0000392	0	26	0	0	26
OG0000393	0	26	0	0	26
OG0000394	0	26	0	0	26
OG0000395	0	0	26	0	26
OG0000396	0	0	26	0	26
OG0000397	0	0	0	26	26
OG0000398	25	0	0	0	25
OG0000399	25	0	0	0	25
OG0000400	24	0	0	1	25
OG0000401	23	0	0	2	25
OG0000402	6	17	0	2	25
OG0000403	24	0	0	1	25
OG0000404	23	0	0	2	25
OG0000405	9	13	0	3	25
OG0000406	1	24	0	0	25
OG0000407	2	0	0	23	25
OG0000408	3	18	0	4	25
OG0000409	7	2	1	15	25
OG0000410	3	11	3	8	25
OG0000411	3	17	1	4	25
OG0000412	3	0	1	21	25
OG0000413	3	21	0	1	25
OG0000414	1	0	0	24	25
OG0000415	5	11	5	4	25
OG0000416	3	6	9	7	25
OG0000417	1	1	21	2	25
OG0000418	0	25	0	0	25
OG0000419	0	25	0	0	25
OG0000420	0	25	0	0	25
OG0000421	0	25	0	0	25
OG0000422	0	25	0	0	25
OG0000423	0	25	0	0	25
OG0000424	0	25	0	0	25
OG0000425	0	25	0	0	25
OG0000426	0	25	0	0	25
OG0000427	0	25	0	0	25
OG0000428	0	25	0	0	25
OG0000429	0	25	0	0	25
OG0000430	0	25	0	0	25
OG0000431	0	0	25	0	25
OG0000432	0	0	0	25	25
OG0000433	0	0	0	25	25
OG0000434	0	0	0	25	25
OG0000435	24	0	0	0	24
OG0000436	24	0	0	0	24
OG0000437	23	0	0	1	24
OG0000438	14	2	1	7	24
OG0000439	7	12	2	3	24
OG0000440	6	13	0	5	24
OG0000441	5	19	0	0	24
OG0000442	7	4	0	13	24
OG0000443	10	3	3	8	24
OG0000444	10	9	0	5	24
OG0000445	7	5	0	12	24
OG0000446	3	19	0	2	24
OG0000447	1	21	0	2	24
OG0000448	4	10	4	6	24
OG0000449	6	12	2	4	24
OG0000450	1	4	18	1	24
OG0000451	1	0	0	23	24
OG0000452	0	24	0	0	24
OG0000453	0	24	0	0	24
OG0000454	0	24	0	0	24
OG0000455	0	24	0	0	24
OG0000456	0	24	0	0	24
OG0000457	0	24	0	0	24
OG0000458	0	24	0	0	24
OG0000459	0	23	0	1	24
OG0000460	0	24	0	0	24
OG0000461	0	24	0	0	24
OG0000462	0	24	0	0	24
OG0000463	0	24	0	0	24
OG0000464	0	24	0	0	24
OG0000465	0	24	0	0	24
OG0000466	0	0	24	0	24
OG0000467	0	0	24	0	24
OG0000468	0	0	0	24	24
OG0000469	0	0	0	24	24
OG0000470	0	0	0	24	24
OG0000471	5	11	5	2	23
OG0000472	23	0	0	0	23
OG0000473	23	0	0	0	23
OG0000474	5	17	1	0	23
OG0000475	20	2	1	0	23
OG0000476	8	2	1	12	23
OG0000477	8	6	1	8	23
OG0000478	22	0	0	1	23
OG0000479	18	4	0	1	23
OG0000480	19	0	0	4	23
OG0000481	22	0	0	1	23
OG0000482	3	0	0	20	23
OG0000483	2	18	0	3	23
OG0000484	1	1	1	20	23
OG0000485	4	0	0	19	23
OG0000486	1	0	0	22	23
OG0000487	2	0	0	21	23
OG0000488	1	0	22	0	23
OG0000489	4	2	3	14	23
OG0000490	0	23	0	0	23
OG0000491	0	23	0	0	23
OG0000492	0	23	0	0	23
OG0000493	0	23	0	0	23
OG0000494	0	23	0	0	23
OG0000495	0	23	0	0	23
OG0000496	0	23	0	0	23
OG0000497	0	23	0	0	23
OG0000498	0	22	0	1	23
OG0000499	0	23	0	0	23
OG0000500	0	23	0	0	23
OG0000501	0	0	23	0	23
OG0000502	0	0	23	0	23
OG0000503	0	0	23	0	23
OG0000504	22	0	0	0	22
OG0000505	5	8	3	6	22
OG0000506	12	7	0	3	22
OG0000507	22	0	0	0	22
OG0000508	9	0	0	13	22
OG0000509	15	2	1	4	22
OG0000510	22	0	0	0	22
OG0000511	22	0	0	0	22
OG0000512	22	0	0	0	22
OG0000513	6	1	1	14	22
OG0000514	12	1	4	5	22
OG0000515	3	19	0	0	22
OG0000516	1	21	0	0	22
OG0000517	22	0	0	0	22
OG0000518	1	1	0	20	22
OG0000519	7	15	0	0	22
OG0000520	2	0	0	20	22
OG0000521	2	0	0	20	22
OG0000522	2	1	0	19	22
OG0000523	8	1	3	10	22
OG0000524	1	0	0	21	22
OG0000525	15	0	0	7	22
OG0000526	1	1	19	1	22
OG0000527	1	21	0	0	22
OG0000528	3	11	6	2	22
OG0000529	1	18	0	3	22
OG0000530	1	0	0	21	22
OG0000531	0	22	0	0	22
OG0000532	0	22	0	0	22
OG0000533	0	22	0	0	22
OG0000534	0	22	0	0	22
OG0000535	0	22	0	0	22
OG0000536	0	22	0	0	22
OG0000537	0	22	0	0	22
OG0000538	0	22	0	0	22
OG0000539	0	22	0	0	22
OG0000540	0	22	0	0	22
OG0000541	0	12	0	10	22
OG0000542	0	22	0	0	22
OG0000543	0	22	0	0	22
OG0000544	0	0	22	0	22
OG0000545	0	0	22	0	22
OG0000546	0	0	22	0	22
OG0000547	0	0	22	0	22
OG0000548	0	0	22	0	22
OG0000549	0	0	0	22	22
OG0000550	0	0	0	22	22
OG0000551	0	0	0	22	22
OG0000552	21	0	0	0	21
OG0000553	16	2	0	3	21
OG0000554	21	0	0	0	21
OG0000555	6	5	4	6	21
OG0000556	21	0	0	0	21
OG0000557	10	2	1	8	21
OG0000558	18	0	0	3	21
OG0000559	21	0	0	0	21
OG0000560	14	1	0	6	21
OG0000561	16	1	0	4	21
OG0000562	2	1	3	15	21
OG0000563	1	16	1	3	21
OG0000564	3	13	3	2	21
OG0000565	3	1	0	17	21
OG0000566	1	20	0	0	21
OG0000567	2	10	3	6	21
OG0000568	6	2	4	9	21
OG0000569	5	7	0	9	21
OG0000570	3	14	0	4	21
OG0000571	2	14	4	1	21
OG0000572	2	19	0	0	21
OG0000573	2	13	4	2	21
OG0000574	2	1	15	3	21
OG0000575	1	0	0	20	21
OG0000576	1	1	18	1	21
OG0000577	0	21	0	0	21
OG0000578	0	21	0	0	21
OG0000579	0	21	0	0	21
OG0000580	0	21	0	0	21
OG0000581	0	1	0	20	21
OG0000582	0	1	20	0	21
OG0000583	0	0	21	0	21
OG0000584	0	0	21	0	21
OG0000585	0	0	21	0	21
OG0000586	0	0	21	0	21
OG0000587	0	0	0	21	21
OG0000588	0	0	0	21	21
OG0000589	0	0	0	21	21
OG0000590	0	0	0	21	21
OG0000591	0	0	0	21	21
OG0000592	0	0	0	21	21
OG0000593	0	0	0	21	21
OG0000594	20	0	0	0	20
OG0000595	9	10	0	1	20
OG0000596	13	1	0	6	20
OG0000597	20	0	0	0	20
OG0000598	19	0	0	1	20
OG0000599	19	0	0	1	20
OG0000600	18	0	0	2	20
OG0000601	13	4	0	3	20
OG0000602	17	0	1	2	20
OG0000603	15	2	0	3	20
OG0000604	4	0	2	14	20
OG0000605	20	0	0	0	20
OG0000606	20	0	0	0	20
OG0000607	3	0	0	17	20
OG0000608	6	4	0	10	20
OG0000609	19	0	0	1	20
OG0000610	20	0	0	0	20
OG0000611	4	11	2	3	20
OG0000612	5	2	0	13	20
OG0000613	8	3	0	9	20
OG0000614	6	1	0	13	20
OG0000615	3	1	0	16	20
OG0000616	1	19	0	0	20
OG0000617	1	1	1	17	20
OG0000618	1	19	0	0	20
OG0000619	6	1	9	4	20
OG0000620	5	6	4	5	20
OG0000621	0	20	0	0	20
OG0000622	0	20	0	0	20
OG0000623	0	20	0	0	20
OG0000624	0	20	0	0	20
OG0000625	0	20	0	0	20
OG0000626	0	20	0	0	20
OG0000627	0	20	0	0	20
OG0000628	0	20	0	0	20
OG0000629	0	20	0	0	20
OG0000630	0	20	0	0	20
OG0000631	0	20	0	0	20
OG0000632	0	1	1	18	20
OG0000633	0	0	20	0	20
OG0000634	0	0	20	0	20
OG0000635	0	0	20	0	20
OG0000636	0	0	20	0	20
OG0000637	0	0	20	0	20
OG0000638	0	0	0	20	20
OG0000639	0	0	0	20	20
OG0000640	0	0	0	20	20
OG0000641	0	0	0	20	20
OG0000642	0	0	0	20	20
OG0000643	0	0	0	20	20
OG0000644	19	0	0	0	19
OG0000645	19	0	0	0	19
OG0000646	2	15	0	2	19
OG0000647	8	0	0	11	19
OG0000648	5	7	0	7	19
OG0000649	19	0	0	0	19
OG0000650	19	0	0	0	19
OG0000651	11	0	0	8	19
OG0000652	16	1	1	1	19
OG0000653	19	0	0	0	19
OG0000654	19	0	0	0	19
OG0000655	14	0	0	5	19
OG0000656	13	6	0	0	19
OG0000657	17	1	0	1	19
OG0000658	5	9	0	5	19
OG0000659	5	1	1	12	19
OG0000660	19	0	0	0	19
OG0000661	19	0	0	0	19
OG0000662	9	5	1	4	19
OG0000663	19	0	0	0	19
OG0000664	5	0	0	14	19
OG0000665	6	10	2	1	19
OG0000666	7	4	4	4	19
OG0000667	7	0	0	12	19
OG0000668	16	0	0	3	19
OG0000669	1	0	18	0	19
OG0000670	4	0	0	15	19
OG0000671	4	6	5	4	19
OG0000672	6	2	2	9	19
OG0000673	5	5	3	6	19
OG0000674	1	3	1	14	19
OG0000675	5	1	1	12	19
OG0000676	3	11	2	3	19
OG0000677	0	19	0	0	19
OG0000678	0	19	0	0	19
OG0000679	0	19	0	0	19
OG0000680	0	19	0	0	19
OG0000681	0	19	0	0	19
OG0000682	0	19	0	0	19
OG0000683	0	19	0	0	19
OG0000684	0	19	0	0	19
OG0000685	0	19	0	0	19
OG0000686	0	19	0	0	19
OG0000687	0	19	0	0	19
OG0000688	0	19	0	0	19
OG0000689	0	19	0	0	19
OG0000690	0	19	0	0	19
OG0000691	0	19	0	0	19
OG0000692	0	19	0	0	19
OG0000693	0	19	0	0	19
OG0000694	0	19	0	0	19
OG0000695	0	1	0	18	19
OG0000696	0	19	0	0	19
OG0000697	0	0	19	0	19
OG0000698	0	0	19	0	19
OG0000699	0	0	19	0	19
OG0000700	0	0	19	0	19
OG0000701	0	0	19	0	19
OG0000702	0	0	0	19	19
OG0000703	0	0	0	19	19
OG0000704	0	0	0	19	19
OG0000705	0	0	0	19	19
OG0000706	18	0	0	0	18
OG0000707	18	0	0	0	18
OG0000708	15	0	0	3	18
OG0000709	6	1	2	9	18
OG0000710	15	0	0	3	18
OG0000711	18	0	0	0	18
OG0000712	18	0	0	0	18
OG0000713	18	0	0	0	18
OG0000714	15	0	0	3	18
OG0000715	18	0	0	0	18
OG0000716	14	2	1	1	18
OG0000717	16	1	0	1	18
OG0000718	13	0	0	5	18
OG0000719	14	0	0	4	18
OG0000720	5	7	1	5	18
OG0000721	7	2	4	5	18
OG0000722	3	13	0	2	18
OG0000723	13	2	1	2	18
OG0000724	18	0	0	0	18
OG0000725	9	6	0	3	18
OG0000726	4	1	5	8	18
OG0000727	1	5	11	1	18
OG0000728	3	8	3	4	18
OG0000729	1	2	1	14	18
OG0000730	1	1	0	16	18
OG0000731	2	10	4	2	18
OG0000732	3	3	2	10	18
OG0000733	2	13	1	2	18
OG0000734	5	4	4	5	18
OG0000735	2	0	0	16	18
OG0000736	8	2	2	6	18
OG0000737	1	17	0	0	18
OG0000738	4	0	0	14	18
OG0000739	1	14	1	2	18
OG0000740	2	12	3	1	18
OG0000741	1	14	2	1	18
OG0000742	0	18	0	0	18
OG0000743	0	18	0	0	18
OG0000744	0	18	0	0	18
OG0000745	0	18	0	0	18
OG0000746	0	18	0	0	18
OG0000747	0	18	0	0	18
OG0000748	0	18	0	0	18
OG0000749	0	18	0	0	18
OG0000750	0	18	0	0	18
OG0000751	0	18	0	0	18
OG0000752	0	18	0	0	18
OG0000753	0	18	0	0	18
OG0000754	0	18	0	0	18
OG0000755	0	18	0	0	18
OG0000756	0	18	0	0	18
OG0000757	0	18	0	0	18
OG0000758	0	18	0	0	18
OG0000759	0	18	0	0	18
OG0000760	0	0	18	0	18
OG0000761	0	0	18	0	18
OG0000762	0	0	18	0	18
OG0000763	0	0	18	0	18
OG0000764	0	0	18	0	18
OG0000765	0	0	0	18	18
OG0000766	0	0	0	18	18
OG0000767	0	0	0	18	18
OG0000768	0	0	0	18	18
OG0000769	0	0	0	18	18
OG0000770	0	0	0	18	18
OG0000771	15	0	0	2	17
OG0000772	16	0	0	1	17
OG0000773	16	0	0	1	17
OG0000774	17	0	0	0	17
OG0000775	4	3	1	9	17
OG0000776	2	1	1	13	17
OG0000777	14	0	0	3	17
OG0000778	17	0	0	0	17
OG0000779	16	0	0	1	17
OG0000780	11	1	0	5	17
OG0000781	17	0	0	0	17
OG0000782	5	9	0	3	17
OG0000783	17	0	0	0	17
OG0000784	17	0	0	0	17
OG0000785	13	1	0	3	17
OG0000786	17	0	0	0	17
OG0000787	14	0	0	3	17
OG0000788	6	0	0	11	17
OG0000789	16	0	0	1	17
OG0000790	6	5	4	2	17
OG0000791	11	2	2	2	17
OG0000792	7	1	1	8	17
OG0000793	14	1	1	1	17
OG0000794	17	0	0	0	17
OG0000795	5	4	3	5	17
OG0000796	13	2	0	2	17
OG0000797	8	0	0	9	17
OG0000798	4	12	0	1	17
OG0000799	2	4	0	11	17
OG0000800	1	0	0	16	17
OG0000801	4	3	4	6	17
OG0000802	4	9	1	3	17
OG0000803	2	9	0	6	17
OG0000804	1	3	2	11	17
OG0000805	5	7	0	5	17
OG0000806	1	13	2	1	17
OG0000807	1	1	0	15	17
OG0000808	1	15	0	1	17
OG0000809	2	12	1	2	17
OG0000810	1	0	0	16	17
OG0000811	0	17	0	0	17
OG0000812	0	17	0	0	17
OG0000813	0	17	0	0	17
OG0000814	0	17	0	0	17
OG0000815	0	17	0	0	17
OG0000816	0	17	0	0	17
OG0000817	0	17	0	0	17
OG0000818	0	17	0	0	17
OG0000819	0	14	0	3	17
OG0000820	0	17	0	0	17
OG0000821	0	17	0	0	17
OG0000822	0	17	0	0	17
OG0000823	0	17	0	0	17
OG0000824	0	17	0	0	17
OG0000825	0	17	0	0	17
OG0000826	0	17	0	0	17
OG0000827	0	17	0	0	17
OG0000828	0	17	0	0	17
OG0000829	0	17	0	0	17
OG0000830	0	17	0	0	17
OG0000831	0	17	0	0	17
OG0000832	0	17	0	0	17
OG0000833	0	17	0	0	17
OG0000834	0	0	17	0	17
OG0000835	0	0	17	0	17
OG0000836	0	0	17	0	17
OG0000837	0	0	0	17	17
OG0000838	0	0	0	17	17
OG0000839	0	0	0	17	17
OG0000840	0	0	0	17	17
OG0000841	0	0	0	17	17
OG0000842	16	0	0	0	16
OG0000843	16	0	0	0	16
OG0000844	4	5	5	2	16
OG0000845	7	1	1	7	16
OG0000846	8	1	1	6	16
OG0000847	10	1	0	5	16
OG0000848	7	0	0	9	16
OG0000849	15	1	0	0	16
OG0000850	16	0	0	0	16
OG0000851	14	0	2	0	16
OG0000852	1	15	0	0	16
OG0000853	15	0	0	1	16
OG0000854	16	0	0	0	16
OG0000855	9	3	2	2	16
OG0000856	15	0	0	1	16
OG0000857	11	2	0	3	16
OG0000858	16	0	0	0	16
OG0000859	6	3	2	5	16
OG0000860	16	0	0	0	16
OG0000861	5	2	1	8	16
OG0000862	16	0	0	0	16
OG0000863	2	11	2	1	16
OG0000864	3	2	0	11	16
OG0000865	1	1	0	14	16
OG0000866	11	2	0	3	16
OG0000867	13	2	1	0	16
OG0000868	7	3	0	6	16
OG0000869	4	2	4	6	16
OG0000870	16	0	0	0	16
OG0000871	15	0	0	1	16
OG0000872	16	0	0	0	16
OG0000873	3	1	0	12	16
OG0000874	2	1	1	12	16
OG0000875	4	4	3	5	16
OG0000876	14	0	0	2	16
OG0000877	16	0	0	0	16
OG0000878	5	1	1	9	16
OG0000879	10	5	0	1	16
OG0000880	6	8	0	2	16
OG0000881	8	3	1	4	16
OG0000882	7	2	0	7	16
OG0000883	1	0	0	15	16
OG0000884	9	1	0	6	16
OG0000885	6	3	1	6	16
OG0000886	3	2	3	8	16
OG0000887	2	14	0	0	16
OG0000888	3	2	1	10	16
OG0000889	1	0	0	15	16
OG0000890	2	9	3	2	16
OG0000891	2	11	1	2	16
OG0000892	1	0	0	15	16
OG0000893	2	7	3	4	16
OG0000894	3	0	0	13	16
OG0000895	4	4	6	2	16
OG0000896	1	13	1	1	16
OG0000897	1	0	0	15	16
OG0000898	2	0	0	14	16
OG0000899	1	5	5	5	16
OG0000900	1	15	0	0	16
OG0000901	2	3	2	9	16
OG0000902	2	1	1	12	16
OG0000903	1	13	1	1	16
OG0000904	1	6	1	8	16
OG0000905	1	12	1	2	16
OG0000906	1	12	1	2	16
OG0000907	1	4	10	1	16
OG0000908	1	8	2	5	16
OG0000909	0	16	0	0	16
OG0000910	0	16	0	0	16
OG0000911	0	16	0	0	16
OG0000912	0	16	0	0	16
OG0000913	0	16	0	0	16
OG0000914	0	16	0	0	16
OG0000915	0	16	0	0	16
OG0000916	0	16	0	0	16
OG0000917	0	16	0	0	16
OG0000918	0	16	0	0	16
OG0000919	0	16	0	0	16
OG0000920	0	16	0	0	16
OG0000921	0	16	0	0	16
OG0000922	0	16	0	0	16
OG0000923	0	16	0	0	16
OG0000924	0	16	0	0	16
OG0000925	0	16	0	0	16
OG0000926	0	0	16	0	16
OG0000927	0	0	16	0	16
OG0000928	0	0	16	0	16
OG0000929	0	0	0	16	16
OG0000930	0	0	0	16	16
OG0000931	0	0	0	16	16
OG0000932	0	0	0	16	16
OG0000933	0	0	0	16	16
OG0000934	0	0	0	16	16
OG0000935	0	0	0	16	16
OG0000936	0	0	0	16	16
OG0000937	0	0	0	16	16
OG0000938	0	0	0	16	16
OG0000939	4	3	6	2	15
OG0000940	15	0	0	0	15
OG0000941	15	0	0	0	15
OG0000942	15	0	0	0	15
OG0000943	14	0	0	1	15
OG0000944	15	0	0	0	15
OG0000945	12	0	1	2	15
OG0000946	15	0	0	0	15
OG0000947	15	0	0	0	15
OG0000948	10	1	0	4	15
OG0000949	14	0	0	1	15
OG0000950	15	0	0	0	15
OG0000951	15	0	0	0	15
OG0000952	15	0	0	0	15
OG0000953	2	6	4	3	15
OG0000954	11	0	0	4	15
OG0000955	14	0	0	1	15
OG0000956	13	0	0	2	15
OG0000957	14	0	0	1	15
OG0000958	15	0	0	0	15
OG0000959	1	11	0	3	15
OG0000960	15	0	0	0	15
OG0000961	15	0	0	0	15
OG0000962	8	2	0	5	15
OG0000963	9	2	0	4	15
OG0000964	10	0	0	5	15
OG0000965	11	1	2	1	15
OG0000966	14	1	0	0	15
OG0000967	14	0	0	1	15
OG0000968	15	0	0	0	15
OG0000969	2	11	1	1	15
OG0000970	6	8	0	1	15
OG0000971	15	0	0	0	15
OG0000972	5	10	0	0	15
OG0000973	5	5	1	4	15
OG0000974	14	0	0	1	15
OG0000975	12	0	0	3	15
OG0000976	2	11	1	1	15
OG0000977	1	9	0	5	15
OG0000978	4	6	3	2	15
OG0000979	8	3	0	4	15
OG0000980	1	14	0	0	15
OG0000981	6	0	0	9	15
OG0000982	9	0	1	5	15
OG0000983	3	4	4	4	15
OG0000984	1	1	1	12	15
OG0000985	7	1	5	2	15
OG0000986	4	1	1	9	15
OG0000987	15	0	0	0	15
OG0000988	14	0	0	1	15
OG0000989	3	1	0	11	15
OG0000990	1	1	1	12	15
OG0000991	1	13	0	1	15
OG0000992	3	8	1	3	15
OG0000993	1	2	2	10	15
OG0000994	4	4	1	6	15
OG0000995	4	3	5	3	15
OG0000996	2	8	4	1	15
OG0000997	1	1	0	13	15
OG0000998	1	13	0	1	15
OG0000999	4	4	0	7	15
OG0001000	2	9	2	2	15
OG0001001	5	1	0	9	15
OG0001002	2	9	1	3	15
OG0001003	1	14	0	0	15
OG0001004	1	3	1	10	15
OG0001005	1	5	8	1	15
OG0001006	1	0	14	0	15
OG0001007	2	3	5	5	15
OG0001008	1	10	3	1	15
OG0001009	1	12	1	1	15
OG0001010	0	15	0	0	15
OG0001011	0	15	0	0	15
OG0001012	0	15	0	0	15
OG0001013	0	8	0	7	15
OG0001014	0	15	0	0	15
OG0001015	0	14	0	1	15
OG0001016	0	15	0	0	15
OG0001017	0	15	0	0	15
OG0001018	0	15	0	0	15
OG0001019	0	15	0	0	15
OG0001020	0	15	0	0	15
OG0001021	0	15	0	0	15
OG0001022	0	15	0	0	15
OG0001023	0	15	0	0	15
OG0001024	0	15	0	0	15
OG0001025	0	15	0	0	15
OG0001026	0	15	0	0	15
OG0001027	0	15	0	0	15
OG0001028	0	15	0	0	15
OG0001029	0	15	0	0	15
OG0001030	0	1	14	0	15
OG0001031	0	15	0	0	15
OG0001032	0	0	15	0	15
OG0001033	0	0	15	0	15
OG0001034	0	0	15	0	15
OG0001035	0	0	15	0	15
OG0001036	0	0	15	0	15
OG0001037	0	0	15	0	15
OG0001038	0	0	15	0	15
OG0001039	0	0	15	0	15
OG0001040	0	0	15	0	15
OG0001041	0	0	0	15	15
OG0001042	0	0	0	15	15
OG0001043	0	0	0	15	15
OG0001044	0	0	0	15	15
OG0001045	0	0	0	15	15
OG0001046	0	0	0	15	15
OG0001047	0	0	0	15	15
OG0001048	0	0	0	15	15
OG0001049	13	0	0	1	14
OG0001050	14	0	0	0	14
OG0001051	7	0	0	7	14
OG0001052	14	0	0	0	14
OG0001053	12	0	0	2	14
OG0001054	11	2	0	1	14
OG0001055	13	0	0	1	14
OG0001056	14	0	0	0	14
OG0001057	4	7	0	3	14
OG0001058	4	5	4	1	14
OG0001059	5	1	1	7	14
OG0001060	12	0	0	2	14
OG0001061	9	3	1	1	14
OG0001062	14	0	0	0	14
OG0001063	8	3	1	2	14
OG0001064	9	1	1	3	14
OG0001065	3	4	0	7	14
OG0001066	14	0	0	0	14
OG0001067	14	0	0	0	14
OG0001068	2	1	1	10	14
OG0001069	13	0	0	1	14
OG0001070	14	0	0	0	14
OG0001071	3	3	3	5	14
OG0001072	14	0	0	0	14
OG0001073	5	1	6	2	14
OG0001074	7	2	0	5	14
OG0001075	3	0	0	11	14
OG0001076	2	10	1	1	14
OG0001077	8	1	1	4	14
OG0001078	14	0	0	0	14
OG0001079	14	0	0	0	14
OG0001080	11	0	0	3	14
OG0001081	5	7	0	2	14
OG0001082	1	12	0	1	14
OG0001083	2	0	0	12	14
OG0001084	13	1	0	0	14
OG0001085	2	10	1	1	14
OG0001086	8	4	1	1	14
OG0001087	1	5	0	8	14
OG0001088	1	13	0	0	14
OG0001089	14	0	0	0	14
OG0001090	1	0	0	13	14
OG0001091	2	2	0	10	14
OG0001092	6	0	0	8	14
OG0001093	2	0	0	12	14
OG0001094	1	0	0	13	14
OG0001095	1	0	0	13	14
OG0001096	8	0	0	6	14
OG0001097	3	7	1	3	14
OG0001098	5	2	3	4	14
OG0001099	4	4	1	5	14
OG0001100	3	5	1	5	14
OG0001101	7	5	2	0	14
OG0001102	1	13	0	0	14
OG0001103	1	2	1	10	14
OG0001104	4	2	3	5	14
OG0001105	2	4	1	7	14
OG0001106	1	9	2	2	14
OG0001107	3	8	1	2	14
OG0001108	4	6	1	3	14
OG0001109	3	6	0	5	14
OG0001110	3	2	6	3	14
OG0001111	1	6	6	1	14
OG0001112	2	7	2	3	14
OG0001113	1	10	2	1	14
OG0001114	1	5	0	8	14
OG0001115	1	11	1	1	14
OG0001116	2	5	2	5	14
OG0001117	3	1	2	8	14
OG0001118	1	3	1	9	14
OG0001119	1	13	0	0	14
OG0001120	1	6	6	1	14
OG0001121	1	11	1	1	14
OG0001122	4	4	1	5	14
OG0001123	2	8	2	2	14
OG0001124	1	6	6	1	14
OG0001125	0	14	0	0	14
OG0001126	0	14	0	0	14
OG0001127	0	14	0	0	14
OG0001128	0	14	0	0	14
OG0001129	0	14	0	0	14
OG0001130	0	14	0	0	14
OG0001131	0	14	0	0	14
OG0001132	0	14	0	0	14
OG0001133	0	14	0	0	14
OG0001134	0	14	0	0	14
OG0001135	0	14	0	0	14
OG0001136	0	13	1	0	14
OG0001137	0	14	0	0	14
OG0001138	0	14	0	0	14
OG0001139	0	14	0	0	14
OG0001140	0	14	0	0	14
OG0001141	0	14	0	0	14
OG0001142	0	14	0	0	14
OG0001143	0	14	0	0	14
OG0001144	0	14	0	0	14
OG0001145	0	14	0	0	14
OG0001146	0	14	0	0	14
OG0001147	0	14	0	0	14
OG0001148	0	14	0	0	14
OG0001149	0	14	0	0	14
OG0001150	0	14	0	0	14
OG0001151	0	0	14	0	14
OG0001152	0	0	14	0	14
OG0001153	0	0	14	0	14
OG0001154	0	0	14	0	14
OG0001155	0	0	14	0	14
OG0001156	0	0	14	0	14
OG0001157	0	0	14	0	14
OG0001158	0	0	14	0	14
OG0001159	0	0	14	0	14
OG0001160	0	0	0	14	14
OG0001161	0	0	0	14	14
OG0001162	0	0	0	14	14
OG0001163	0	0	0	14	14
OG0001164	0	0	0	14	14
OG0001165	0	0	0	14	14
OG0001166	0	0	0	14	14
OG0001167	0	0	0	14	14
OG0001168	0	0	0	14	14
OG0001169	0	0	0	14	14
OG0001170	12	0	0	1	13
OG0001171	13	0	0	0	13
OG0001172	12	0	0	1	13
OG0001173	13	0	0	0	13
OG0001174	12	1	0	0	13
OG0001175	11	0	1	1	13
OG0001176	13	0	0	0	13
OG0001177	2	1	0	10	13
OG0001178	13	0	0	0	13
OG0001179	8	2	0	3	13
OG0001180	5	0	0	8	13
OG0001181	7	0	1	5	13
OG0001182	6	2	2	3	13
OG0001183	7	1	2	3	13
OG0001184	11	0	0	2	13
OG0001185	12	0	0	1	13
OG0001186	3	1	0	9	13
OG0001187	3	0	0	10	13
OG0001188	10	0	0	3	13
OG0001189	12	0	0	1	13
OG0001190	13	0	0	0	13
OG0001191	13	0	0	0	13
OG0001192	12	0	0	1	13
OG0001193	9	0	0	4	13
OG0001194	4	3	4	2	13
OG0001195	13	0	0	0	13
OG0001196	2	0	0	11	13
OG0001197	5	1	0	7	13
OG0001198	7	1	1	4	13
OG0001199	13	0	0	0	13
OG0001200	4	0	0	9	13
OG0001201	11	0	2	0	13
OG0001202	12	0	0	1	13
OG0001203	10	0	0	3	13
OG0001204	3	5	2	3	13
OG0001205	10	1	0	2	13
OG0001206	2	10	0	1	13
OG0001207	5	0	1	7	13
OG0001208	2	1	0	10	13
OG0001209	10	1	0	2	13
OG0001210	6	2	1	4	13
OG0001211	2	0	0	11	13
OG0001212	4	1	0	8	13
OG0001213	7	1	1	4	13
OG0001214	12	1	0	0	13
OG0001215	1	0	0	12	13
OG0001216	5	3	1	4	13
OG0001217	5	2	4	2	13
OG0001218	13	0	0	0	13
OG0001219	3	3	2	5	13
OG0001220	4	2	1	6	13
OG0001221	4	5	2	2	13
OG0001222	13	0	0	0	13
OG0001223	3	4	3	3	13
OG0001224	2	5	0	6	13
OG0001225	12	0	0	1	13
OG0001226	13	0	0	0	13
OG0001227	4	0	1	8	13
OG0001228	13	0	0	0	13
OG0001229	5	2	1	5	13
OG0001230	3	0	1	9	13
OG0001231	3	0	0	10	13
OG0001232	2	2	0	9	13
OG0001233	4	2	1	6	13
OG0001234	8	2	1	2	13
OG0001235	10	3	0	0	13
OG0001236	4	1	3	5	13
OG0001237	2	0	0	11	13
OG0001238	1	0	0	12	13
OG0001239	2	0	3	8	13
OG0001240	13	0	0	0	13
OG0001241	1	5	2	5	13
OG0001242	1	8	1	3	13
OG0001243	12	0	0	1	13
OG0001244	2	10	0	1	13
OG0001245	3	7	0	3	13
OG0001246	1	4	7	1	13
OG0001247	4	6	1	2	13
OG0001248	2	11	0	0	13
OG0001249	1	0	0	12	13
OG0001250	3	3	3	4	13
OG0001251	2	0	0	11	13
OG0001252	3	6	0	4	13
OG0001253	1	10	1	1	13
OG0001254	1	0	0	12	13
OG0001255	1	10	1	1	13
OG0001256	2	8	1	2	13
OG0001257	2	4	4	3	13
OG0001258	4	5	1	3	13
OG0001259	1	0	1	11	13
OG0001260	1	4	0	8	13
OG0001261	2	4	5	2	13
OG0001262	4	4	3	2	13
OG0001263	3	5	2	3	13
OG0001264	1	7	3	2	13
OG0001265	2	6	4	1	13
OG0001266	2	8	0	3	13
OG0001267	1	0	12	0	13
OG0001268	2	7	0	4	13
OG0001269	1	9	2	1	13
OG0001270	1	0	1	11	13
OG0001271	2	5	4	2	13
OG0001272	4	4	1	4	13
OG0001273	1	10	1	1	13
OG0001274	1	11	0	1	13
OG0001275	1	11	0	1	13
OG0001276	0	13	0	0	13
OG0001277	0	12	0	1	13
OG0001278	0	13	0	0	13
OG0001279	0	13	0	0	13
OG0001280	0	13	0	0	13
OG0001281	0	13	0	0	13
OG0001282	0	13	0	0	13
OG0001283	0	13	0	0	13
OG0001284	0	13	0	0	13
OG0001285	0	13	0	0	13
OG0001286	0	13	0	0	13
OG0001287	0	10	3	0	13
OG0001288	0	13	0	0	13
OG0001289	0	13	0	0	13
OG0001290	0	13	0	0	13
OG0001291	0	12	0	1	13
OG0001292	0	13	0	0	13
OG0001293	0	13	0	0	13
OG0001294	0	13	0	0	13
OG0001295	0	13	0	0	13
OG0001296	0	13	0	0	13
OG0001297	0	13	0	0	13
OG0001298	0	13	0	0	13
OG0001299	0	13	0	0	13
OG0001300	0	13	0	0	13
OG0001301	0	1	12	0	13
OG0001302	0	0	13	0	13
OG0001303	0	0	13	0	13
OG0001304	0	0	13	0	13
OG0001305	0	0	13	0	13
OG0001306	0	0	0	13	13
OG0001307	0	0	0	13	13
OG0001308	0	0	0	13	13
OG0001309	0	0	0	13	13
OG0001310	0	0	0	13	13
OG0001311	0	0	0	13	13
OG0001312	0	0	0	13	13
OG0001313	0	0	0	13	13
OG0001314	2	0	0	10	12
OG0001315	4	2	2	4	12
OG0001316	12	0	0	0	12
OG0001317	8	1	1	2	12
OG0001318	6	1	1	4	12
OG0001319	10	0	0	2	12
OG0001320	11	0	0	1	12
OG0001321	12	0	0	0	12
OG0001322	11	0	0	1	12
OG0001323	12	0	0	0	12
OG0001324	3	5	1	3	12
OG0001325	4	5	1	2	12
OG0001326	12	0	0	0	12
OG0001327	12	0	0	0	12
OG0001328	12	0	0	0	12
OG0001329	11	0	0	1	12
OG0001330	2	0	0	10	12
OG0001331	12	0	0	0	12
OG0001332	7	2	1	2	12
OG0001333	11	0	0	1	12
OG0001334	6	3	1	2	12
OG0001335	12	0	0	0	12
OG0001336	9	0	0	3	12
OG0001337	4	2	2	4	12
OG0001338	2	2	2	6	12
OG0001339	8	0	0	4	12
OG0001340	8	2	1	1	12
OG0001341	11	0	0	1	12
OG0001342	8	1	1	2	12
OG0001343	6	3	0	3	12
OG0001344	9	1	1	1	12
OG0001345	5	3	3	1	12
OG0001346	12	0	0	0	12
OG0001347	3	7	0	2	12
OG0001348	12	0	0	0	12
OG0001349	10	0	0	2	12
OG0001350	12	0	0	0	12
OG0001351	12	0	0	0	12
OG0001352	9	1	0	2	12
OG0001353	8	1	2	1	12
OG0001354	10	0	0	2	12
OG0001355	12	0	0	0	12
OG0001356	3	1	0	8	12
OG0001357	2	7	2	1	12
OG0001358	2	2	7	1	12
OG0001359	1	8	0	3	12
OG0001360	2	0	0	10	12
OG0001361	7	0	0	5	12
OG0001362	12	0	0	0	12
OG0001363	6	3	0	3	12
OG0001364	2	0	0	10	12
OG0001365	5	1	1	5	12
OG0001366	3	3	2	4	12
OG0001367	10	1	0	1	12
OG0001368	12	0	0	0	12
OG0001369	12	0	0	0	12
OG0001370	9	1	1	1	12
OG0001371	5	1	3	3	12
OG0001372	1	11	0	0	12
OG0001373	12	0	0	0	12
OG0001374	2	2	7	1	12
OG0001375	3	8	0	1	12
OG0001376	10	1	0	1	12
OG0001377	4	8	0	0	12
OG0001378	12	0	0	0	12
OG0001379	2	2	0	8	12
OG0001380	2	0	0	10	12
OG0001381	12	0	0	0	12
OG0001382	7	0	1	4	12
OG0001383	11	0	0	1	12
OG0001384	4	3	2	3	12
OG0001385	7	0	0	5	12
OG0001386	12	0	0	0	12
OG0001387	9	0	1	2	12
OG0001388	1	11	0	0	12
OG0001389	2	1	1	8	12
OG0001390	2	9	0	1	12
OG0001391	1	0	0	11	12
OG0001392	3	3	1	5	12
OG0001393	4	0	3	5	12
OG0001394	2	0	0	10	12
OG0001395	3	2	1	6	12
OG0001396	2	9	0	1	12
OG0001397	3	5	2	2	12
OG0001398	2	10	0	0	12
OG0001399	4	0	0	8	12
OG0001400	3	1	1	7	12
OG0001401	1	0	0	11	12
OG0001402	2	7	2	1	12
OG0001403	2	0	1	9	12
OG0001404	1	0	0	11	12
OG0001405	5	1	0	6	12
OG0001406	2	2	7	1	12
OG0001407	3	4	2	3	12
OG0001408	1	11	0	0	12
OG0001409	1	1	1	9	12
OG0001410	3	2	5	2	12
OG0001411	1	0	1	10	12
OG0001412	2	0	0	10	12
OG0001413	2	1	4	5	12
OG0001414	3	0	5	4	12
OG0001415	4	1	2	5	12
OG0001416	1	0	0	11	12
OG0001417	1	0	0	11	12
OG0001418	3	9	0	0	12
OG0001419	3	5	0	4	12
OG0001420	2	5	3	2	12
OG0001421	2	4	4	2	12
OG0001422	1	2	3	6	12
OG0001423	1	11	0	0	12
OG0001424	3	3	2	4	12
OG0001425	4	1	2	5	12
OG0001426	2	5	1	4	12
OG0001427	1	4	0	7	12
OG0001428	1	1	3	7	12
OG0001429	3	5	2	2	12
OG0001430	1	1	1	9	12
OG0001431	0	11	0	1	12
OG0001432	0	12	0	0	12
OG0001433	0	12	0	0	12
OG0001434	0	12	0	0	12
OG0001435	0	12	0	0	12
OG0001436	0	12	0	0	12
OG0001437	0	12	0	0	12
OG0001438	0	12	0	0	12
OG0001439	0	12	0	0	12
OG0001440	0	12	0	0	12
OG0001441	0	12	0	0	12
OG0001442	0	12	0	0	12
OG0001443	0	12	0	0	12
OG0001444	0	12	0	0	12
OG0001445	0	1	0	11	12
OG0001446	0	12	0	0	12
OG0001447	0	12	0	0	12
OG0001448	0	12	0	0	12
OG0001449	0	12	0	0	12
OG0001450	0	12	0	0	12
OG0001451	0	12	0	0	12
OG0001452	0	8	0	4	12
OG0001453	0	12	0	0	12
OG0001454	0	12	0	0	12
OG0001455	0	12	0	0	12
OG0001456	0	12	0	0	12
OG0001457	0	12	0	0	12
OG0001458	0	12	0	0	12
OG0001459	0	12	0	0	12
OG0001460	0	12	0	0	12
OG0001461	0	12	0	0	12
OG0001462	0	12	0	0	12
OG0001463	0	12	0	0	12
OG0001464	0	12	0	0	12
OG0001465	0	12	0	0	12
OG0001466	0	0	12	0	12
OG0001467	0	0	12	0	12
OG0001468	0	0	12	0	12
OG0001469	0	0	12	0	12
OG0001470	0	0	12	0	12
OG0001471	0	0	12	0	12
OG0001472	0	0	12	0	12
OG0001473	0	0	12	0	12
OG0001474	0	0	12	0	12
OG0001475	0	0	12	0	12
OG0001476	0	0	0	12	12
OG0001477	0	0	0	12	12
OG0001478	0	0	0	12	12
OG0001479	0	0	0	12	12
OG0001480	0	0	0	12	12
OG0001481	0	0	0	12	12
OG0001482	0	0	0	12	12
OG0001483	0	0	0	12	12
OG0001484	0	0	0	12	12
OG0001485	0	0	0	12	12
OG0001486	0	0	0	12	12
OG0001487	0	0	0	12	12
OG0001488	0	0	0	12	12
OG0001489	0	0	0	12	12
OG0001490	0	0	0	12	12
OG0001491	0	0	0	12	12
OG0001492	0	0	0	12	12
OG0001493	0	0	0	12	12
OG0001494	6	1	1	3	11
OG0001495	2	1	6	2	11
OG0001496	6	2	2	1	11
OG0001497	2	1	2	6	11
OG0001498	11	0	0	0	11
OG0001499	9	0	0	2	11
OG0001500	10	0	1	0	11
OG0001501	5	5	0	1	11
OG0001502	11	0	0	0	11
OG0001503	9	0	0	2	11
OG0001504	11	0	0	0	11
OG0001505	11	0	0	0	11
OG0001506	4	4	2	1	11
OG0001507	10	0	0	1	11
OG0001508	11	0	0	0	11
OG0001509	10	0	0	1	11
OG0001510	11	0	0	0	11
OG0001511	11	0	0	0	11
OG0001512	7	1	0	3	11
OG0001513	3	2	3	3	11
OG0001514	7	0	0	4	11
OG0001515	11	0	0	0	11
OG0001516	3	4	0	4	11
OG0001517	7	2	1	1	11
OG0001518	4	6	0	1	11
OG0001519	7	1	1	2	11
OG0001520	3	3	2	3	11
OG0001521	2	1	1	7	11
OG0001522	9	0	0	2	11
OG0001523	8	2	0	1	11
OG0001524	5	3	1	2	11
OG0001525	7	2	1	1	11
OG0001526	2	6	2	1	11
OG0001527	7	3	0	1	11
OG0001528	2	0	0	9	11
OG0001529	5	0	0	6	11
OG0001530	8	0	0	3	11
OG0001531	2	0	0	9	11
OG0001532	7	3	0	1	11
OG0001533	7	1	1	2	11
OG0001534	4	1	2	4	11
OG0001535	9	2	0	0	11
OG0001536	11	0	0	0	11
OG0001537	11	0	0	0	11
OG0001538	4	1	1	5	11
OG0001539	6	4	0	1	11
OG0001540	7	2	0	2	11
OG0001541	7	0	1	3	11
OG0001542	7	1	1	2	11
OG0001543	3	0	0	8	11
OG0001544	11	0	0	0	11
OG0001545	11	0	0	0	11
OG0001546	5	3	2	1	11
OG0001547	7	1	1	2	11
OG0001548	6	0	0	5	11
OG0001549	4	1	0	6	11
OG0001550	11	0	0	0	11
OG0001551	1	0	3	7	11
OG0001552	9	0	2	0	11
OG0001553	4	0	0	7	11
OG0001554	6	3	0	2	11
OG0001555	3	3	2	3	11
OG0001556	4	1	5	1	11
OG0001557	11	0	0	0	11
OG0001558	10	0	0	1	11
OG0001559	11	0	0	0	11
OG0001560	6	1	1	3	11
OG0001561	3	0	0	8	11
OG0001562	5	1	0	5	11
OG0001563	2	2	6	1	11
OG0001564	2	7	0	2	11
OG0001565	10	0	0	1	11
OG0001566	4	6	0	1	11
OG0001567	4	1	1	5	11
OG0001568	9	0	0	2	11
OG0001569	8	0	0	3	11
OG0001570	6	0	0	5	11
OG0001571	3	2	1	5	11
OG0001572	1	0	0	10	11
OG0001573	7	4	0	0	11
OG0001574	3	6	0	2	11
OG0001575	5	0	1	5	11
OG0001576	11	0	0	0	11
OG0001577	7	1	2	1	11
OG0001578	1	1	0	9	11
OG0001579	6	0	1	4	11
OG0001580	4	3	0	4	11
OG0001581	2	1	1	7	11
OG0001582	5	2	2	2	11
OG0001583	6	1	2	2	11
OG0001584	3	0	0	8	11
OG0001585	8	0	0	3	11
OG0001586	11	0	0	0	11
OG0001587	11	0	0	0	11
OG0001588	11	0	0	0	11
OG0001589	6	1	0	4	11
OG0001590	2	1	1	7	11
OG0001591	3	6	1	1	11
OG0001592	1	0	0	10	11
OG0001593	9	0	0	2	11
OG0001594	6	0	0	5	11
OG0001595	3	6	0	2	11
OG0001596	7	1	0	3	11
OG0001597	2	8	0	1	11
OG0001598	6	0	0	5	11
OG0001599	3	2	5	1	11
OG0001600	1	0	2	8	11
OG0001601	7	0	0	4	11
OG0001602	3	2	5	1	11
OG0001603	1	1	0	9	11
OG0001604	4	1	1	5	11
OG0001605	6	3	1	1	11
OG0001606	2	7	0	2	11
OG0001607	4	3	0	4	11
OG0001608	1	2	2	6	11
OG0001609	2	1	1	7	11
OG0001610	5	1	0	5	11
OG0001611	9	0	0	2	11
OG0001612	1	0	0	10	11
OG0001613	2	4	4	1	11
OG0001614	7	0	0	4	11
OG0001615	1	9	0	1	11
OG0001616	2	3	1	5	11
OG0001617	6	0	0	5	11
OG0001618	3	0	0	8	11
OG0001619	1	8	1	1	11
OG0001620	2	2	3	4	11
OG0001621	1	4	3	3	11
OG0001622	2	0	0	9	11
OG0001623	2	7	0	2	11
OG0001624	1	0	0	10	11
OG0001625	1	7	2	1	11
OG0001626	2	5	2	2	11
OG0001627	2	2	4	3	11
OG0001628	1	5	3	2	11
OG0001629	3	0	1	7	11
OG0001630	2	6	2	1	11
OG0001631	2	7	1	1	11
OG0001632	3	2	3	3	11
OG0001633	4	1	1	5	11
OG0001634	2	0	0	9	11
OG0001635	2	4	1	4	11
OG0001636	3	1	0	7	11
OG0001637	1	2	2	6	11
OG0001638	2	4	0	5	11
OG0001639	1	6	2	2	11
OG0001640	4	0	2	5	11
OG0001641	3	4	2	2	11
OG0001642	2	1	0	8	11
OG0001643	2	4	3	2	11
OG0001644	1	6	3	1	11
OG0001645	1	0	0	10	11
OG0001646	1	0	1	9	11
OG0001647	1	8	1	1	11
OG0001648	1	10	0	0	11
OG0001649	2	5	2	2	11
OG0001650	1	2	7	1	11
OG0001651	2	5	3	1	11
OG0001652	1	0	0	10	11
OG0001653	2	3	4	2	11
OG0001654	2	4	3	2	11
OG0001655	4	1	0	6	11
OG0001656	1	10	0	0	11
OG0001657	1	6	2	2	11
OG0001658	1	1	1	8	11
OG0001659	3	4	1	3	11
OG0001660	1	7	0	3	11
OG0001661	1	3	6	1	11
OG0001662	1	6	3	1	11
OG0001663	1	8	1	1	11
OG0001664	1	8	1	1	11
OG0001665	1	5	4	1	11
OG0001666	1	9	1	0	11
OG0001667	1	2	7	1	11
OG0001668	1	6	2	2	11
OG0001669	1	0	10	0	11
OG0001670	1	5	0	5	11
OG0001671	1	4	0	6	11
OG0001672	1	4	4	2	11
OG0001673	1	10	0	0	11
OG0001674	1	7	2	1	11
OG0001675	1	0	9	1	11
OG0001676	0	11	0	0	11
OG0001677	0	11	0	0	11
OG0001678	0	11	0	0	11
OG0001679	0	11	0	0	11
OG0001680	0	11	0	0	11
OG0001681	0	11	0	0	11
OG0001682	0	11	0	0	11
OG0001683	0	11	0	0	11
OG0001684	0	11	0	0	11
OG0001685	0	11	0	0	11
OG0001686	0	11	0	0	11
OG0001687	0	11	0	0	11
OG0001688	0	11	0	0	11
OG0001689	0	11	0	0	11
OG0001690	0	11	0	0	11
OG0001691	0	11	0	0	11
OG0001692	0	11	0	0	11
OG0001693	0	11	0	0	11
OG0001694	0	11	0	0	11
OG0001695	0	11	0	0	11
OG0001696	0	11	0	0	11
OG0001697	0	11	0	0	11
OG0001698	0	11	0	0	11
OG0001699	0	11	0	0	11
OG0001700	0	11	0	0	11
OG0001701	0	11	0	0	11
OG0001702	0	11	0	0	11
OG0001703	0	11	0	0	11
OG0001704	0	11	0	0	11
OG0001705	0	11	0	0	11
OG0001706	0	11	0	0	11
OG0001707	0	11	0	0	11
OG0001708	0	11	0	0	11
OG0001709	0	11	0	0	11
OG0001710	0	11	0	0	11
OG0001711	0	11	0	0	11
OG0001712	0	11	0	0	11
OG0001713	0	11	0	0	11
OG0001714	0	11	0	0	11
OG0001715	0	11	0	0	11
OG0001716	0	11	0	0	11
OG0001717	0	11	0	0	11
OG0001718	0	11	0	0	11
OG0001719	0	11	0	0	11
OG0001720	0	11	0	0	11
OG0001721	0	11	0	0	11
OG0001722	0	11	0	0	11
OG0001723	0	11	0	0	11
OG0001724	0	11	0	0	11
OG0001725	0	0	11	0	11
OG0001726	0	0	11	0	11
OG0001727	0	0	11	0	11
OG0001728	0	0	11	0	11
OG0001729	0	0	11	0	11
OG0001730	0	0	11	0	11
OG0001731	0	0	11	0	11
OG0001732	0	0	11	0	11
OG0001733	0	0	11	0	11
OG0001734	0	0	11	0	11
OG0001735	0	0	11	0	11
OG0001736	0	0	11	0	11
OG0001737	0	0	11	0	11
OG0001738	0	0	11	0	11
OG0001739	0	0	11	0	11
OG0001740	0	0	11	0	11
OG0001741	0	0	0	11	11
OG0001742	0	0	0	11	11
OG0001743	0	0	0	11	11
OG0001744	0	0	0	11	11
OG0001745	0	0	0	11	11
OG0001746	0	0	0	11	11
OG0001747	0	0	0	11	11
OG0001748	0	0	0	11	11
OG0001749	0	0	0	11	11
OG0001750	0	0	0	11	11
OG0001751	0	0	0	11	11
OG0001752	0	0	0	11	11
OG0001753	0	0	0	11	11
OG0001754	0	0	0	11	11
OG0001755	0	0	0	11	11
OG0001756	0	0	0	11	11
OG0001757	0	0	0	11	11
OG0001758	0	0	0	11	11
OG0001759	0	0	0	11	11
OG0001760	0	0	0	11	11
OG0001761	10	0	0	0	10
OG0001762	2	4	3	1	10
OG0001763	2	1	3	4	10
OG0001764	4	2	2	2	10
OG0001765	5	1	1	3	10
OG0001766	2	0	0	8	10
OG0001767	5	1	0	4	10
OG0001768	9	0	0	1	10
OG0001769	6	1	0	3	10
OG0001770	3	1	2	4	10
OG0001771	9	0	0	1	10
OG0001772	7	2	0	1	10
OG0001773	10	0	0	0	10
OG0001774	10	0	0	0	10
OG0001775	10	0	0	0	10
OG0001776	9	0	0	1	10
OG0001777	10	0	0	0	10
OG0001778	7	1	1	1	10
OG0001779	10	0	0	0	10
OG0001780	10	0	0	0	10
OG0001781	8	0	0	2	10
OG0001782	6	2	1	1	10
OG0001783	10	0	0	0	10
OG0001784	5	0	3	2	10
OG0001785	10	0	0	0	10
OG0001786	9	0	0	1	10
OG0001787	7	0	0	3	10
OG0001788	10	0	0	0	10
OG0001789	6	2	1	1	10
OG0001790	8	0	0	2	10
OG0001791	3	2	1	4	10
OG0001792	10	0	0	0	10
OG0001793	10	0	0	0	10
OG0001794	10	0	0	0	10
OG0001795	2	1	1	6	10
OG0001796	2	4	2	2	10
OG0001797	10	0	0	0	10
OG0001798	6	2	0	2	10
OG0001799	6	0	1	3	10
OG0001800	4	3	2	1	10
OG0001801	3	1	4	2	10
OG0001802	8	0	0	2	10
OG0001803	5	0	0	5	10
OG0001804	10	0	0	0	10
OG0001805	6	2	1	1	10
OG0001806	3	1	2	4	10
OG0001807	10	0	0	0	10
OG0001808	2	0	2	6	10
OG0001809	4	1	2	3	10
OG0001810	10	0	0	0	10
OG0001811	10	0	0	0	10
OG0001812	3	2	3	2	10
OG0001813	8	0	0	2	10
OG0001814	5	3	0	2	10
OG0001815	6	1	0	3	10
OG0001816	7	1	1	1	10
OG0001817	2	6	1	1	10
OG0001818	2	4	1	3	10
OG0001819	4	2	0	4	10
OG0001820	1	1	0	8	10
OG0001821	3	2	3	2	10
OG0001822	8	1	0	1	10
OG0001823	4	0	0	6	10
OG0001824	7	1	1	1	10
OG0001825	6	0	0	4	10
OG0001826	10	0	0	0	10
OG0001827	10	0	0	0	10
OG0001828	10	0	0	0	10
OG0001829	3	3	2	2	10
OG0001830	4	1	3	2	10
OG0001831	4	0	0	6	10
OG0001832	4	2	2	2	10
OG0001833	5	2	0	3	10
OG0001834	9	0	0	1	10
OG0001835	9	0	0	1	10
OG0001836	6	1	2	1	10
OG0001837	3	4	0	3	10
OG0001838	7	3	0	0	10
OG0001839	10	0	0	0	10
OG0001840	3	1	0	6	10
OG0001841	3	2	0	5	10
OG0001842	4	1	0	5	10
OG0001843	6	1	1	2	10
OG0001844	1	4	0	5	10
OG0001845	10	0	0	0	10
OG0001846	10	0	0	0	10
OG0001847	4	1	1	4	10
OG0001848	6	2	1	1	10
OG0001849	5	3	1	1	10
OG0001850	6	0	0	4	10
OG0001851	10	0	0	0	10
OG0001852	2	2	2	4	10
OG0001853	10	0	0	0	10
OG0001854	10	0	0	0	10
OG0001855	4	3	1	2	10
OG0001856	1	0	0	9	10
OG0001857	2	0	0	8	10
OG0001858	5	1	3	1	10
OG0001859	4	0	0	6	10
OG0001860	10	0	0	0	10
OG0001861	3	4	1	2	10
OG0001862	7	1	0	2	10
OG0001863	5	1	2	2	10
OG0001864	4	0	4	2	10
OG0001865	4	4	0	2	10
OG0001866	2	0	0	8	10
OG0001867	2	6	1	1	10
OG0001868	7	0	2	1	10
OG0001869	3	2	1	4	10
OG0001870	2	1	1	6	10
OG0001871	10	0	0	0	10
OG0001872	5	0	1	4	10
OG0001873	3	0	0	7	10
OG0001874	5	4	0	1	10
OG0001875	7	1	1	1	10
OG0001876	10	0	0	0	10
OG0001877	1	9	0	0	10
OG0001878	1	9	0	0	10
OG0001879	6	0	0	4	10
OG0001880	1	2	0	7	10
OG0001881	4	2	1	3	10
OG0001882	9	0	0	1	10
OG0001883	2	6	0	2	10
OG0001884	2	5	1	2	10
OG0001885	9	1	0	0	10
OG0001886	3	0	0	7	10
OG0001887	4	2	1	3	10
OG0001888	1	2	1	6	10
OG0001889	1	9	0	0	10
OG0001890	3	1	3	3	10
OG0001891	4	0	0	6	10
OG0001892	2	3	3	2	10
OG0001893	2	2	2	4	10
OG0001894	9	1	0	0	10
OG0001895	5	0	4	1	10
OG0001896	4	0	0	6	10
OG0001897	1	1	1	7	10
OG0001898	2	0	0	8	10
OG0001899	3	6	0	1	10
OG0001900	4	2	3	1	10
OG0001901	2	0	1	7	10
OG0001902	1	2	6	1	10
OG0001903	1	7	1	1	10
OG0001904	1	1	7	1	10
OG0001905	1	1	1	7	10
OG0001906	4	0	0	6	10
OG0001907	3	2	0	5	10
OG0001908	4	2	0	4	10
OG0001909	8	0	0	2	10
OG0001910	2	4	1	3	10
OG0001911	2	2	3	3	10
OG0001912	1	0	0	9	10
OG0001913	9	0	0	1	10
OG0001914	2	3	3	2	10
OG0001915	1	1	1	7	10
OG0001916	2	1	5	2	10
OG0001917	1	5	1	3	10
OG0001918	1	1	1	7	10
OG0001919	2	5	2	1	10
OG0001920	2	1	2	5	10
OG0001921	1	3	4	2	10
OG0001922	1	4	4	1	10
OG0001923	3	3	1	3	10
OG0001924	2	2	2	4	10
OG0001925	2	0	0	8	10
OG0001926	2	3	2	3	10
OG0001927	5	2	1	2	10
OG0001928	1	2	6	1	10
OG0001929	1	2	4	3	10
OG0001930	1	3	4	2	10
OG0001931	2	0	0	8	10
OG0001932	2	2	3	3	10
OG0001933	1	5	2	2	10
OG0001934	2	2	4	2	10
OG0001935	1	2	2	5	10
OG0001936	2	3	0	5	10
OG0001937	1	6	1	2	10
OG0001938	1	7	0	2	10
OG0001939	2	4	1	3	10
OG0001940	2	4	1	3	10
OG0001941	1	6	0	3	10
OG0001942	2	2	1	5	10
OG0001943	2	4	2	2	10
OG0001944	2	6	0	2	10
OG0001945	1	8	1	0	10
OG0001946	1	8	0	1	10
OG0001947	2	1	4	3	10
OG0001948	1	0	0	9	10
OG0001949	2	4	3	1	10
OG0001950	1	3	3	3	10
OG0001951	2	0	0	8	10
OG0001952	2	2	3	3	10
OG0001953	1	8	0	1	10
OG0001954	1	1	0	8	10
OG0001955	3	2	0	5	10
OG0001956	1	8	0	1	10
OG0001957	3	4	0	3	10
OG0001958	1	2	6	1	10
OG0001959	1	1	0	8	10
OG0001960	1	2	1	6	10
OG0001961	1	4	4	1	10
OG0001962	1	1	2	6	10
OG0001963	1	8	0	1	10
OG0001964	1	2	1	6	10
OG0001965	1	5	3	1	10
OG0001966	4	1	1	4	10
OG0001967	1	5	2	2	10
OG0001968	1	4	0	5	10
OG0001969	1	8	0	1	10
OG0001970	1	1	0	8	10
OG0001971	1	9	0	0	10
OG0001972	1	4	3	2	10
OG0001973	1	7	0	2	10
OG0001974	2	2	5	1	10
OG0001975	2	4	3	1	10
OG0001976	2	2	3	3	10
OG0001977	1	5	2	2	10
OG0001978	2	7	0	1	10
OG0001979	1	4	1	4	10
OG0001980	2	2	2	4	10
OG0001981	2	2	0	6	10
OG0001982	1	0	0	9	10
OG0001983	0	10	0	0	10
OG0001984	0	10	0	0	10
OG0001985	0	10	0	0	10
OG0001986	0	10	0	0	10
OG0001987	0	8	0	2	10
OG0001988	0	10	0	0	10
OG0001989	0	10	0	0	10
OG0001990	0	10	0	0	10
OG0001991	0	10	0	0	10
OG0001992	0	10	0	0	10
OG0001993	0	10	0	0	10
OG0001994	0	10	0	0	10
OG0001995	0	10	0	0	10
OG0001996	0	5	0	5	10
OG0001997	0	10	0	0	10
OG0001998	0	10	0	0	10
OG0001999	0	10	0	0	10
OG0002000	0	10	0	0	10
OG0002001	0	5	0	5	10
OG0002002	0	10	0	0	10
OG0002003	0	10	0	0	10
OG0002004	0	2	0	8	10
OG0002005	0	10	0	0	10
OG0002006	0	10	0	0	10
OG0002007	0	10	0	0	10
OG0002008	0	10	0	0	10
OG0002009	0	10	0	0	10
OG0002010	0	10	0	0	10
OG0002011	0	10	0	0	10
OG0002012	0	10	0	0	10
OG0002013	0	10	0	0	10
OG0002014	0	10	0	0	10
OG0002015	0	10	0	0	10
OG0002016	0	10	0	0	10
OG0002017	0	10	0	0	10
OG0002018	0	10	0	0	10
OG0002019	0	7	0	3	10
OG0002020	0	10	0	0	10
OG0002021	0	10	0	0	10
OG0002022	0	10	0	0	10
OG0002023	0	10	0	0	10
OG0002024	0	10	0	0	10
OG0002025	0	10	0	0	10
OG0002026	0	10	0	0	10
OG0002027	0	10	0	0	10
OG0002028	0	10	0	0	10
OG0002029	0	10	0	0	10
OG0002030	0	10	0	0	10
OG0002031	0	10	0	0	10
OG0002032	0	10	0	0	10
OG0002033	0	10	0	0	10
OG0002034	0	10	0	0	10
OG0002035	0	10	0	0	10
OG0002036	0	1	9	0	10
OG0002037	0	10	0	0	10
OG0002038	0	10	0	0	10
OG0002039	0	10	0	0	10
OG0002040	0	10	0	0	10
OG0002041	0	1	9	0	10
OG0002042	0	1	0	9	10
OG0002043	0	0	10	0	10
OG0002044	0	0	10	0	10
OG0002045	0	0	10	0	10
OG0002046	0	0	10	0	10
OG0002047	0	0	10	0	10
OG0002048	0	0	10	0	10
OG0002049	0	0	10	0	10
OG0002050	0	0	10	0	10
OG0002051	0	0	10	0	10
OG0002052	0	0	10	0	10
OG0002053	0	0	10	0	10
OG0002054	0	0	10	0	10
OG0002055	0	0	10	0	10
OG0002056	0	0	10	0	10
OG0002057	0	0	10	0	10
OG0002058	0	0	1	9	10
OG0002059	0	0	0	10	10
OG0002060	0	0	0	10	10
OG0002061	0	0	0	10	10
OG0002062	0	0	0	10	10
OG0002063	0	0	0	10	10
OG0002064	0	0	0	10	10
OG0002065	0	0	0	10	10
OG0002066	0	0	0	10	10
OG0002067	0	0	0	10	10
OG0002068	0	0	0	10	10
OG0002069	0	0	0	10	10
OG0002070	0	0	0	10	10
OG0002071	0	0	0	10	10
OG0002072	0	0	0	10	10
OG0002073	0	0	0	10	10
OG0002074	0	0	0	10	10
OG0002075	0	0	0	10	10
OG0002076	0	0	0	10	10
OG0002077	0	0	0	10	10
OG0002078	0	0	0	10	10
OG0002079	0	0	0	10	10
OG0002080	0	0	0	10	10
OG0002081	0	0	0	10	10
OG0002082	0	0	0	10	10
OG0002083	0	0	0	10	10
OG0002084	0	0	0	10	10
OG0002085	0	0	0	10	10
OG0002086	0	0	0	10	10
OG0002087	0	0	0	10	10
OG0002088	0	0	0	10	10
OG0002089	5	2	1	1	9
OG0002090	4	0	1	4	9
OG0002091	7	0	0	2	9
OG0002092	6	2	0	1	9
OG0002093	1	0	0	8	9
OG0002094	9	0	0	0	9
OG0002095	6	0	0	3	9
OG0002096	9	0	0	0	9
OG0002097	9	0	0	0	9
OG0002098	7	0	0	2	9
OG0002099	9	0	0	0	9
OG0002100	8	0	0	1	9
OG0002101	9	0	0	0	9
OG0002102	9	0	0	0	9
OG0002103	4	3	1	1	9
OG0002104	4	3	1	1	9
OG0002105	6	1	1	1	9
OG0002106	2	3	3	1	9
OG0002107	3	1	1	4	9
OG0002108	9	0	0	0	9
OG0002109	7	2	0	0	9
OG0002110	9	0	0	0	9
OG0002111	9	0	0	0	9
OG0002112	9	0	0	0	9
OG0002113	4	1	2	2	9
OG0002114	5	2	1	1	9
OG0002115	3	3	1	2	9
OG0002116	7	0	0	2	9
OG0002117	3	1	2	3	9
OG0002118	4	2	1	2	9
OG0002119	4	5	0	0	9
OG0002120	9	0	0	0	9
OG0002121	4	1	2	2	9
OG0002122	4	2	2	1	9
OG0002123	3	0	0	6	9
OG0002124	3	0	1	5	9
OG0002125	9	0	0	0	9
OG0002126	9	0	0	0	9
OG0002127	6	0	0	3	9
OG0002128	9	0	0	0	9
OG0002129	4	3	0	2	9
OG0002130	6	0	0	3	9
OG0002131	9	0	0	0	9
OG0002132	3	1	4	1	9
OG0002133	9	0	0	0	9
OG0002134	7	0	0	2	9
OG0002135	9	0	0	0	9
OG0002136	2	0	0	7	9
OG0002137	4	4	0	1	9
OG0002138	9	0	0	0	9
OG0002139	6	1	2	0	9
OG0002140	1	1	6	1	9
OG0002141	6	0	1	2	9
OG0002142	5	2	1	1	9
OG0002143	3	1	3	2	9
OG0002144	9	0	0	0	9
OG0002145	3	2	0	4	9
OG0002146	1	0	0	8	9
OG0002147	4	1	2	2	9
OG0002148	7	1	0	1	9
OG0002149	3	1	3	2	9
OG0002150	2	4	2	1	9
OG0002151	3	5	0	1	9
OG0002152	9	0	0	0	9
OG0002153	1	0	0	8	9
OG0002154	5	2	1	1	9
OG0002155	8	0	0	1	9
OG0002156	6	0	0	3	9
OG0002157	7	0	0	2	9
OG0002158	9	0	0	0	9
OG0002159	2	6	0	1	9
OG0002160	3	0	0	6	9
OG0002161	7	0	0	2	9
OG0002162	9	0	0	0	9
OG0002163	9	0	0	0	9
OG0002164	4	1	1	3	9
OG0002165	9	0	0	0	9
OG0002166	5	1	1	2	9
OG0002167	9	0	0	0	9
OG0002168	6	1	1	1	9
OG0002169	5	1	1	2	9
OG0002170	6	1	1	1	9
OG0002171	3	1	3	2	9
OG0002172	3	1	1	4	9
OG0002173	3	1	3	2	9
OG0002174	9	0	0	0	9
OG0002175	8	0	0	1	9
OG0002176	4	3	1	1	9
OG0002177	9	0	0	0	9
OG0002178	3	3	1	2	9
OG0002179	2	0	0	7	9
OG0002180	3	1	4	1	9
OG0002181	4	4	0	1	9
OG0002182	3	2	1	3	9
OG0002183	9	0	0	0	9
OG0002184	3	1	2	3	9
OG0002185	6	3	0	0	9
OG0002186	8	0	0	1	9
OG0002187	8	0	0	1	9
OG0002188	3	0	1	5	9
OG0002189	1	4	0	4	9
OG0002190	3	2	2	2	9
OG0002191	2	3	2	2	9
OG0002192	6	3	0	0	9
OG0002193	6	0	0	3	9
OG0002194	2	1	1	5	9
OG0002195	9	0	0	0	9
OG0002196	3	2	0	4	9
OG0002197	9	0	0	0	9
OG0002198	3	4	1	1	9
OG0002199	2	0	0	7	9
OG0002200	3	1	0	5	9
OG0002201	5	1	2	1	9
OG0002202	2	3	0	4	9
OG0002203	4	4	0	1	9
OG0002204	2	1	4	2	9
OG0002205	9	0	0	0	9
OG0002206	2	1	0	6	9
OG0002207	3	2	3	1	9
OG0002208	7	0	0	2	9
OG0002209	5	1	0	3	9
OG0002210	7	0	0	2	9
OG0002211	1	0	0	8	9
OG0002212	2	0	0	7	9
OG0002213	3	1	1	4	9
OG0002214	1	3	0	5	9
OG0002215	5	1	1	2	9
OG0002216	4	2	0	3	9
OG0002217	3	1	2	3	9
OG0002218	2	4	1	2	9
OG0002219	4	2	0	3	9
OG0002220	8	0	0	1	9
OG0002221	1	2	0	6	9
OG0002222	2	1	1	5	9
OG0002223	7	0	0	2	9
OG0002224	2	5	1	1	9
OG0002225	4	4	0	1	9
OG0002226	4	1	3	1	9
OG0002227	7	0	0	2	9
OG0002228	2	1	1	5	9
OG0002229	4	2	2	1	9
OG0002230	7	0	0	2	9
OG0002231	5	1	1	2	9
OG0002232	3	0	0	6	9
OG0002233	9	0	0	0	9
OG0002234	6	0	0	3	9
OG0002235	9	0	0	0	9
OG0002236	2	0	0	7	9
OG0002237	3	1	3	2	9
OG0002238	2	3	1	3	9
OG0002239	2	2	2	3	9
OG0002240	2	1	1	5	9
OG0002241	9	0	0	0	9
OG0002242	4	2	2	1	9
OG0002243	9	0	0	0	9
OG0002244	9	0	0	0	9
OG0002245	4	0	0	5	9
OG0002246	1	8	0	0	9
OG0002247	5	0	0	4	9
OG0002248	9	0	0	0	9
OG0002249	6	0	0	3	9
OG0002250	5	2	0	2	9
OG0002251	4	1	1	3	9
OG0002252	9	0	0	0	9
OG0002253	1	0	0	8	9
OG0002254	4	1	2	2	9
OG0002255	4	1	0	4	9
OG0002256	2	0	0	7	9
OG0002257	9	0	0	0	9
OG0002258	5	0	0	4	9
OG0002259	3	2	1	3	9
OG0002260	1	0	0	8	9
OG0002261	3	1	0	5	9
OG0002262	1	0	0	8	9
OG0002263	3	1	4	1	9
OG0002264	5	1	0	3	9
OG0002265	5	4	0	0	9
OG0002266	2	4	1	2	9
OG0002267	1	0	0	8	9
OG0002268	3	1	2	3	9
OG0002269	7	0	0	2	9
OG0002270	2	2	1	4	9
OG0002271	3	3	2	1	9
OG0002272	3	0	0	6	9
OG0002273	1	0	0	8	9
OG0002274	3	3	1	2	9
OG0002275	8	1	0	0	9
OG0002276	4	3	1	1	9
OG0002277	2	0	1	6	9
OG0002278	2	0	0	7	9
OG0002279	2	1	3	3	9
OG0002280	1	2	0	6	9
OG0002281	1	2	5	1	9
OG0002282	1	1	0	7	9
OG0002283	1	0	0	8	9
OG0002284	1	1	5	2	9
OG0002285	9	0	0	0	9
OG0002286	1	0	0	8	9
OG0002287	2	4	0	3	9
OG0002288	2	2	4	1	9
OG0002289	9	0	0	0	9
OG0002290	2	5	1	1	9
OG0002291	1	1	4	3	9
OG0002292	2	4	0	3	9
OG0002293	2	4	1	2	9
OG0002294	1	1	1	6	9
OG0002295	4	0	0	5	9
OG0002296	1	0	0	8	9
OG0002297	3	0	0	6	9
OG0002298	1	0	0	8	9
OG0002299	3	1	1	4	9
OG0002300	2	2	2	3	9
OG0002301	2	2	1	4	9
OG0002302	5	0	0	4	9
OG0002303	3	0	0	6	9
OG0002304	3	0	0	6	9
OG0002305	8	0	0	1	9
OG0002306	1	0	0	8	9
OG0002307	1	7	0	1	9
OG0002308	2	3	1	3	9
OG0002309	3	2	3	1	9
OG0002310	1	4	1	3	9
OG0002311	1	1	2	5	9
OG0002312	6	0	0	3	9
OG0002313	1	4	2	2	9
OG0002314	1	2	4	2	9
OG0002315	9	0	0	0	9
OG0002316	1	0	0	8	9
OG0002317	1	4	3	1	9
OG0002318	4	4	0	1	9
OG0002319	2	7	0	0	9
OG0002320	1	3	1	4	9
OG0002321	1	0	0	8	9
OG0002322	2	4	1	2	9
OG0002323	2	3	1	3	9
OG0002324	2	2	4	1	9
OG0002325	2	3	2	2	9
OG0002326	2	2	2	3	9
OG0002327	1	1	3	4	9
OG0002328	1	6	0	2	9
OG0002329	2	4	1	2	9
OG0002330	1	1	0	7	9
OG0002331	1	1	1	6	9
OG0002332	1	3	4	1	9
OG0002333	2	2	3	2	9
OG0002334	2	1	3	3	9
OG0002335	1	2	5	1	9
OG0002336	1	3	2	3	9
OG0002337	2	2	0	5	9
OG0002338	2	2	1	4	9
OG0002339	2	1	1	5	9
OG0002340	1	3	2	3	9
OG0002341	1	1	6	1	9
OG0002342	1	1	1	6	9
OG0002343	2	0	0	7	9
OG0002344	2	1	4	2	9
OG0002345	1	1	1	6	9
OG0002346	2	3	2	2	9
OG0002347	1	0	0	8	9
OG0002348	1	0	0	8	9
OG0002349	1	2	1	5	9
OG0002350	1	0	0	8	9
OG0002351	1	1	0	7	9
OG0002352	1	0	1	7	9
OG0002353	6	1	1	1	9
OG0002354	1	0	0	8	9
OG0002355	1	0	0	8	9
OG0002356	1	7	0	1	9
OG0002357	1	0	0	8	9
OG0002358	2	1	5	1	9
OG0002359	1	1	0	7	9
OG0002360	1	1	6	1	9
OG0002361	1	3	4	1	9
OG0002362	1	1	6	1	9
OG0002363	1	3	0	5	9
OG0002364	1	2	1	5	9
OG0002365	1	0	0	8	9
OG0002366	1	3	3	2	9
OG0002367	2	2	3	2	9
OG0002368	1	1	5	2	9
OG0002369	2	2	4	1	9
OG0002370	1	6	1	1	9
OG0002371	1	3	4	1	9
OG0002372	1	2	3	3	9
OG0002373	1	6	1	1	9
OG0002374	2	2	2	3	9
OG0002375	1	7	1	0	9
OG0002376	1	3	2	3	9
OG0002377	1	6	1	1	9
OG0002378	1	6	1	1	9
OG0002379	4	0	1	4	9
OG0002380	2	0	0	7	9
OG0002381	2	0	0	7	9
OG0002382	2	3	2	2	9
OG0002383	2	0	0	7	9
OG0002384	2	2	3	2	9
OG0002385	4	3	0	2	9
OG0002386	1	3	4	1	9
OG0002387	1	4	3	1	9
OG0002388	1	6	0	2	9
OG0002389	1	3	2	3	9
OG0002390	1	1	5	2	9
OG0002391	1	1	1	6	9
OG0002392	1	3	2	3	9
OG0002393	2	1	4	2	9
OG0002394	3	2	2	2	9
OG0002395	1	5	2	1	9
OG0002396	1	6	1	1	9
OG0002397	1	1	2	5	9
OG0002398	1	3	4	1	9
OG0002399	2	2	3	2	9
OG0002400	2	2	3	2	9
OG0002401	5	1	1	2	9
OG0002402	1	4	2	2	9
OG0002403	1	4	3	1	9
OG0002404	1	4	1	3	9
OG0002405	1	0	0	8	9
OG0002406	1	0	0	8	9
OG0002407	2	4	2	1	9
OG0002408	1	3	1	4	9
OG0002409	1	0	0	8	9
OG0002410	1	3	4	1	9
OG0002411	1	6	1	1	9
OG0002412	1	1	6	1	9
OG0002413	1	2	4	2	9
OG0002414	1	2	5	1	9
OG0002415	1	1	5	2	9
OG0002416	2	1	3	3	9
OG0002417	1	0	0	8	9
OG0002418	1	3	4	1	9
OG0002419	2	2	3	2	9
OG0002420	1	5	1	2	9
OG0002421	1	1	5	2	9
OG0002422	1	5	1	2	9
OG0002423	1	7	0	1	9
OG0002424	1	7	0	1	9
OG0002425	1	5	1	2	9
OG0002426	1	1	6	1	9
OG0002427	1	2	4	2	9
OG0002428	1	5	2	1	9
OG0002429	2	1	5	1	9
OG0002430	1	0	0	8	9
OG0002431	1	3	4	1	9
OG0002432	1	2	5	1	9
OG0002433	1	0	6	2	9
OG0002434	1	6	1	1	9
OG0002435	0	9	0	0	9
OG0002436	0	9	0	0	9
OG0002437	0	9	0	0	9
OG0002438	0	9	0	0	9
OG0002439	0	9	0	0	9
OG0002440	0	9	0	0	9
OG0002441	0	9	0	0	9
OG0002442	0	9	0	0	9
OG0002443	0	9	0	0	9
OG0002444	0	9	0	0	9
OG0002445	0	9	0	0	9
OG0002446	0	9	0	0	9
OG0002447	0	9	0	0	9
OG0002448	0	9	0	0	9
OG0002449	0	9	0	0	9
OG0002450	0	6	0	3	9
OG0002451	0	9	0	0	9
OG0002452	0	9	0	0	9
OG0002453	0	9	0	0	9
OG0002454	0	9	0	0	9
OG0002455	0	9	0	0	9
OG0002456	0	9	0	0	9
OG0002457	0	9	0	0	9
OG0002458	0	9	0	0	9
OG0002459	0	9	0	0	9
OG0002460	0	9	0	0	9
OG0002461	0	9	0	0	9
OG0002462	0	9	0	0	9
OG0002463	0	9	0	0	9
OG0002464	0	9	0	0	9
OG0002465	0	9	0	0	9
OG0002466	0	9	0	0	9
OG0002467	0	9	0	0	9
OG0002468	0	9	0	0	9
OG0002469	0	9	0	0	9
OG0002470	0	9	0	0	9
OG0002471	0	9	0	0	9
OG0002472	0	9	0	0	9
OG0002473	0	9	0	0	9
OG0002474	0	9	0	0	9
OG0002475	0	9	0	0	9
OG0002476	0	9	0	0	9
OG0002477	0	9	0	0	9
OG0002478	0	9	0	0	9
OG0002479	0	9	0	0	9
OG0002480	0	9	0	0	9
OG0002481	0	9	0	0	9
OG0002482	0	9	0	0	9
OG0002483	0	9	0	0	9
OG0002484	0	9	0	0	9
OG0002485	0	9	0	0	9
OG0002486	0	2	0	7	9
OG0002487	0	9	0	0	9
OG0002488	0	1	1	7	9
OG0002489	0	1	0	8	9
OG0002490	0	9	0	0	9
OG0002491	0	9	0	0	9
OG0002492	0	9	0	0	9
OG0002493	0	9	0	0	9
OG0002494	0	9	0	0	9
OG0002495	0	1	0	8	9
OG0002496	0	9	0	0	9
OG0002497	0	9	0	0	9
OG0002498	0	2	0	7	9
OG0002499	0	1	0	8	9
OG0002500	0	0	9	0	9
OG0002501	0	0	9	0	9
OG0002502	0	0	9	0	9
OG0002503	0	0	9	0	9
OG0002504	0	0	9	0	9
OG0002505	0	0	9	0	9
OG0002506	0	0	9	0	9
OG0002507	0	0	9	0	9
OG0002508	0	0	9	0	9
OG0002509	0	0	9	0	9
OG0002510	0	0	9	0	9
OG0002511	0	0	9	0	9
OG0002512	0	0	9	0	9
OG0002513	0	0	9	0	9
OG0002514	0	0	9	0	9
OG0002515	0	0	0	9	9
OG0002516	0	0	0	9	9
OG0002517	0	0	0	9	9
OG0002518	0	0	0	9	9
OG0002519	0	0	0	9	9
OG0002520	0	0	0	9	9
OG0002521	0	0	0	9	9
OG0002522	0	0	0	9	9
OG0002523	0	0	0	9	9
OG0002524	0	0	0	9	9
OG0002525	0	0	0	9	9
OG0002526	0	0	0	9	9
OG0002527	0	0	0	9	9
OG0002528	0	0	0	9	9
OG0002529	0	0	0	9	9
OG0002530	0	0	0	9	9
OG0002531	0	0	0	9	9
OG0002532	0	0	0	9	9
OG0002533	0	0	0	9	9
OG0002534	0	0	0	9	9
OG0002535	0	0	0	9	9
OG0002536	0	0	0	9	9
OG0002537	0	0	0	9	9
OG0002538	0	0	0	9	9
OG0002539	0	0	0	9	9
OG0002540	0	0	0	9	9
OG0002541	0	0	0	9	9
OG0002542	0	0	0	9	9
OG0002543	0	0	0	9	9
OG0002544	0	0	0	9	9
OG0002545	0	0	0	9	9
OG0002546	0	0	0	9	9
OG0002547	0	0	0	9	9
OG0002548	0	0	0	9	9
OG0002549	0	0	0	9	9
OG0002550	0	0	0	9	9
OG0002551	0	0	0	9	9
OG0002552	0	0	0	9	9
OG0002553	0	0	0	9	9
OG0002554	0	0	0	9	9
OG0002555	0	0	0	9	9
OG0002556	0	0	0	9	9
OG0002557	0	0	0	9	9
OG0002558	0	0	0	9	9
OG0002559	0	0	0	9	9
OG0002560	0	0	0	9	9
OG0002561	0	0	0	9	9
OG0002562	0	0	0	9	9
OG0002563	2	2	0	4	8
OG0002564	7	0	0	1	8
OG0002565	8	0	0	0	8
OG0002566	7	1	0	0	8
OG0002567	3	1	2	2	8
OG0002568	8	0	0	0	8
OG0002569	4	1	1	2	8
OG0002570	8	0	0	0	8
OG0002571	3	3	1	1	8
OG0002572	8	0	0	0	8
OG0002573	4	2	0	2	8
OG0002574	8	0	0	0	8
OG0002575	8	0	0	0	8
OG0002576	4	0	0	4	8
OG0002577	3	0	1	4	8
OG0002578	3	2	0	3	8
OG0002579	1	1	2	4	8
OG0002580	2	4	1	1	8
OG0002581	4	1	2	1	8
OG0002582	5	0	2	1	8
OG0002583	7	0	0	1	8
OG0002584	2	3	1	2	8
OG0002585	8	0	0	0	8
OG0002586	4	0	0	4	8
OG0002587	6	0	0	2	8
OG0002588	8	0	0	0	8
OG0002589	8	0	0	0	8
OG0002590	8	0	0	0	8
OG0002591	7	0	0	1	8
OG0002592	4	1	0	3	8
OG0002593	8	0	0	0	8
OG0002594	2	0	0	6	8
OG0002595	7	0	0	1	8
OG0002596	4	2	1	1	8
OG0002597	5	0	0	3	8
OG0002598	2	1	1	4	8
OG0002599	4	2	1	1	8
OG0002600	6	0	0	2	8
OG0002601	7	1	0	0	8
OG0002602	3	1	0	4	8
OG0002603	6	1	0	1	8
OG0002604	3	3	0	2	8
OG0002605	5	2	0	1	8
OG0002606	4	2	1	1	8
OG0002607	8	0	0	0	8
OG0002608	8	0	0	0	8
OG0002609	2	0	6	0	8
OG0002610	3	2	1	2	8
OG0002611	8	0	0	0	8
OG0002612	2	0	0	6	8
OG0002613	8	0	0	0	8
OG0002614	8	0	0	0	8
OG0002615	7	0	0	1	8
OG0002616	3	2	2	1	8
OG0002617	4	0	2	2	8
OG0002618	8	0	0	0	8
OG0002619	8	0	0	0	8
OG0002620	8	0	0	0	8
OG0002621	4	2	1	1	8
OG0002622	2	1	0	5	8
OG0002623	3	2	1	2	8
OG0002624	4	1	2	1	8
OG0002625	6	0	1	1	8
OG0002626	1	0	0	7	8
OG0002627	2	1	4	1	8
OG0002628	2	0	0	6	8
OG0002629	5	1	1	1	8
OG0002630	4	1	2	1	8
OG0002631	7	0	0	1	8
OG0002632	3	2	1	2	8
OG0002633	4	1	2	1	8
OG0002634	3	2	1	2	8
OG0002635	2	2	1	3	8
OG0002636	3	1	1	3	8
OG0002637	3	2	0	3	8
OG0002638	8	0	0	0	8
OG0002639	4	2	1	1	8
OG0002640	8	0	0	0	8
OG0002641	3	3	1	1	8
OG0002642	4	2	1	1	8
OG0002643	8	0	0	0	8
OG0002644	5	1	1	1	8
OG0002645	3	1	2	2	8
OG0002646	8	0	0	0	8
OG0002647	6	0	0	2	8
OG0002648	3	0	0	5	8
OG0002649	5	1	0	2	8
OG0002650	2	1	3	2	8
OG0002651	5	1	1	1	8
OG0002652	4	1	1	2	8
OG0002653	2	4	1	1	8
OG0002654	4	1	0	3	8
OG0002655	4	1	0	3	8
OG0002656	8	0	0	0	8
OG0002657	4	1	1	2	8
OG0002658	7	0	0	1	8
OG0002659	8	0	0	0	8
OG0002660	3	2	0	3	8
OG0002661	3	2	2	1	8
OG0002662	4	1	1	2	8
OG0002663	2	0	1	5	8
OG0002664	4	1	1	2	8
OG0002665	8	0	0	0	8
OG0002666	3	3	1	1	8
OG0002667	3	3	0	2	8
OG0002668	8	0	0	0	8
OG0002669	8	0	0	0	8
OG0002670	3	0	0	5	8
OG0002671	3	1	2	2	8
OG0002672	3	1	2	2	8
OG0002673	2	1	3	2	8
OG0002674	2	4	1	1	8
OG0002675	7	1	0	0	8
OG0002676	3	2	1	2	8
OG0002677	8	0	0	0	8
OG0002678	3	1	1	3	8
OG0002679	6	0	0	2	8
OG0002680	3	0	0	5	8
OG0002681	4	1	0	3	8
OG0002682	7	0	0	1	8
OG0002683	2	2	2	2	8
OG0002684	7	0	0	1	8
OG0002685	8	0	0	0	8
OG0002686	4	0	0	4	8
OG0002687	3	2	2	1	8
OG0002688	2	3	1	2	8
OG0002689	2	1	2	3	8
OG0002690	3	3	1	1	8
OG0002691	3	0	0	5	8
OG0002692	2	3	1	2	8
OG0002693	3	0	0	5	8
OG0002694	2	0	1	5	8
OG0002695	8	0	0	0	8
OG0002696	8	0	0	0	8
OG0002697	7	0	0	1	8
OG0002698	2	2	2	2	8
OG0002699	3	3	1	1	8
OG0002700	2	0	0	6	8
OG0002701	3	2	1	2	8
OG0002702	3	1	1	3	8
OG0002703	4	1	2	1	8
OG0002704	8	0	0	0	8
OG0002705	3	4	0	1	8
OG0002706	3	3	1	1	8
OG0002707	7	0	0	1	8
OG0002708	2	2	3	1	8
OG0002709	4	1	1	2	8
OG0002710	3	1	1	3	8
OG0002711	2	1	2	3	8
OG0002712	6	0	1	1	8
OG0002713	5	1	0	2	8
OG0002714	4	1	1	2	8
OG0002715	5	1	1	1	8
OG0002716	2	0	0	6	8
OG0002717	8	0	0	0	8
OG0002718	7	0	0	1	8
OG0002719	4	2	1	1	8
OG0002720	4	1	1	2	8
OG0002721	2	6	0	0	8
OG0002722	8	0	0	0	8
OG0002723	2	4	1	1	8
OG0002724	4	0	0	4	8
OG0002725	2	1	2	3	8
OG0002726	8	0	0	0	8
OG0002727	5	0	0	3	8
OG0002728	3	0	0	5	8
OG0002729	6	0	0	2	8
OG0002730	6	0	2	0	8
OG0002731	7	0	0	1	8
OG0002732	8	0	0	0	8
OG0002733	1	0	0	7	8
OG0002734	6	0	0	2	8
OG0002735	1	0	0	7	8
OG0002736	2	1	0	5	8
OG0002737	3	3	1	1	8
OG0002738	1	0	0	7	8
OG0002739	5	0	0	3	8
OG0002740	3	3	1	1	8
OG0002741	3	2	2	1	8
OG0002742	4	1	2	1	8
OG0002743	4	2	0	2	8
OG0002744	8	0	0	0	8
OG0002745	3	3	1	1	8
OG0002746	3	1	2	2	8
OG0002747	2	1	0	5	8
OG0002748	2	1	3	2	8
OG0002749	7	0	0	1	8
OG0002750	2	3	1	2	8
OG0002751	6	1	0	1	8
OG0002752	5	0	0	3	8
OG0002753	5	0	2	1	8
OG0002754	6	0	0	2	8
OG0002755	5	1	1	1	8
OG0002756	8	0	0	0	8
OG0002757	4	2	1	1	8
OG0002758	7	1	0	0	8
OG0002759	1	1	5	1	8
OG0002760	2	1	3	2	8
OG0002761	5	2	0	1	8
OG0002762	3	2	2	1	8
OG0002763	8	0	0	0	8
OG0002764	8	0	0	0	8
OG0002765	5	0	0	3	8
OG0002766	4	1	1	2	8
OG0002767	8	0	0	0	8
OG0002768	6	1	1	0	8
OG0002769	8	0	0	0	8
OG0002770	2	2	3	1	8
OG0002771	4	0	0	4	8
OG0002772	7	0	0	1	8
OG0002773	2	3	2	1	8
OG0002774	2	3	1	2	8
OG0002775	2	1	1	4	8
OG0002776	1	0	0	7	8
OG0002777	5	2	0	1	8
OG0002778	1	2	0	5	8
OG0002779	2	6	0	0	8
OG0002780	4	1	0	3	8
OG0002781	2	0	0	6	8
OG0002782	2	4	1	1	8
OG0002783	6	1	0	1	8
OG0002784	5	0	0	3	8
OG0002785	2	1	1	4	8
OG0002786	8	0	0	0	8
OG0002787	1	3	3	1	8
OG0002788	2	2	0	4	8
OG0002789	3	0	0	5	8
OG0002790	3	0	4	1	8
OG0002791	3	0	0	5	8
OG0002792	8	0	0	0	8
OG0002793	3	0	0	5	8
OG0002794	6	1	0	1	8
OG0002795	4	1	2	1	8
OG0002796	1	0	0	7	8
OG0002797	8	0	0	0	8
OG0002798	5	0	0	3	8
OG0002799	2	3	1	2	8
OG0002800	3	3	0	2	8
OG0002801	1	0	0	7	8
OG0002802	8	0	0	0	8
OG0002803	1	0	1	6	8
OG0002804	2	3	2	1	8
OG0002805	2	1	3	2	8
OG0002806	4	0	0	4	8
OG0002807	1	0	0	7	8
OG0002808	3	2	1	2	8
OG0002809	2	0	0	6	8
OG0002810	2	0	0	6	8
OG0002811	1	0	0	7	8
OG0002812	1	2	2	3	8
OG0002813	6	0	0	2	8
OG0002814	4	1	0	3	8
OG0002815	2	1	0	5	8
OG0002816	2	1	3	2	8
OG0002817	2	1	4	1	8
OG0002818	1	2	2	3	8
OG0002819	8	0	0	0	8
OG0002820	8	0	0	0	8
OG0002821	1	1	4	2	8
OG0002822	3	1	0	4	8
OG0002823	4	4	0	0	8
OG0002824	4	0	0	4	8
OG0002825	3	0	0	5	8
OG0002826	2	3	0	3	8
OG0002827	8	0	0	0	8
OG0002828	2	3	1	2	8
OG0002829	1	3	2	2	8
OG0002830	3	0	0	5	8
OG0002831	4	4	0	0	8
OG0002832	1	1	1	5	8
OG0002833	1	6	0	1	8
OG0002834	1	2	4	1	8
OG0002835	2	0	0	6	8
OG0002836	4	2	0	2	8
OG0002837	1	1	5	1	8
OG0002838	1	0	0	7	8
OG0002839	1	1	1	5	8
OG0002840	1	5	1	1	8
OG0002841	1	3	3	1	8
OG0002842	2	0	0	6	8
OG0002843	4	0	0	4	8
OG0002844	4	1	0	3	8
OG0002845	1	2	3	2	8
OG0002846	1	2	0	5	8
OG0002847	1	1	1	5	8
OG0002848	1	1	4	2	8
OG0002849	1	1	1	5	8
OG0002850	1	4	1	2	8
OG0002851	2	1	0	5	8
OG0002852	3	2	1	2	8
OG0002853	1	3	3	1	8
OG0002854	4	3	0	1	8
OG0002855	3	2	0	3	8
OG0002856	1	1	3	3	8
OG0002857	2	3	1	2	8
OG0002858	2	0	1	5	8
OG0002859	2	2	0	4	8
OG0002860	4	1	1	2	8
OG0002861	1	0	0	7	8
OG0002862	1	5	1	1	8
OG0002863	2	0	0	6	8
OG0002864	1	0	6	1	8
OG0002865	1	0	0	7	8
OG0002866	1	2	4	1	8
OG0002867	2	2	2	2	8
OG0002868	1	2	2	3	8
OG0002869	4	2	0	2	8
OG0002870	1	4	1	2	8
OG0002871	1	4	1	2	8
OG0002872	2	1	2	3	8
OG0002873	1	0	0	7	8
OG0002874	2	4	0	2	8
OG0002875	3	1	1	3	8
OG0002876	2	1	0	5	8
OG0002877	1	1	4	2	8
OG0002878	1	2	0	5	8
OG0002879	2	0	0	6	8
OG0002880	1	1	4	2	8
OG0002881	2	0	0	6	8
OG0002882	1	0	0	7	8
OG0002883	3	0	2	3	8
OG0002884	3	2	0	3	8
OG0002885	1	3	3	1	8
OG0002886	1	1	1	5	8
OG0002887	2	1	3	2	8
OG0002888	3	1	2	2	8
OG0002889	2	5	0	1	8
OG0002890	1	0	0	7	8
OG0002891	1	2	3	2	8
OG0002892	2	0	1	5	8
OG0002893	1	1	4	2	8
OG0002894	1	5	1	1	8
OG0002895	2	1	3	2	8
OG0002896	1	1	1	5	8
OG0002897	1	1	1	5	8
OG0002898	3	1	0	4	8
OG0002899	2	2	2	2	8
OG0002900	7	1	0	0	8
OG0002901	1	1	2	4	8
OG0002902	1	3	0	4	8
OG0002903	3	2	0	3	8
OG0002904	8	0	0	0	8
OG0002905	1	5	1	1	8
OG0002906	1	3	3	1	8
OG0002907	1	1	1	5	8
OG0002908	2	2	1	3	8
OG0002909	2	1	3	2	8
OG0002910	1	1	0	6	8
OG0002911	2	3	1	2	8
OG0002912	1	4	1	2	8
OG0002913	2	2	2	2	8
OG0002914	1	0	0	7	8
OG0002915	1	2	3	2	8
OG0002916	2	1	0	5	8
OG0002917	1	4	1	2	8
OG0002918	1	0	0	7	8
OG0002919	1	2	2	3	8
OG0002920	1	2	1	4	8
OG0002921	2	0	1	5	8
OG0002922	1	1	5	1	8
OG0002923	1	0	0	7	8
OG0002924	1	0	0	7	8
OG0002925	2	1	3	2	8
OG0002926	2	0	0	6	8
OG0002927	2	4	1	1	8
OG0002928	1	4	2	1	8
OG0002929	1	2	2	3	8
OG0002930	2	1	0	5	8
OG0002931	1	1	1	5	8
OG0002932	3	1	2	2	8
OG0002933	1	3	3	1	8
OG0002934	2	2	2	2	8
OG0002935	2	3	1	2	8
OG0002936	1	1	0	6	8
OG0002937	1	3	1	3	8
OG0002938	2	0	0	6	8
OG0002939	2	5	0	1	8
OG0002940	1	1	3	3	8
OG0002941	2	0	4	2	8
OG0002942	1	2	0	5	8
OG0002943	3	0	0	5	8
OG0002944	2	1	1	4	8
OG0002945	2	1	3	2	8
OG0002946	1	0	0	7	8
OG0002947	1	2	1	4	8
OG0002948	3	2	1	2	8
OG0002949	2	3	1	2	8
OG0002950	3	1	0	4	8
OG0002951	3	3	1	1	8
OG0002952	1	3	3	1	8
OG0002953	1	2	1	4	8
OG0002954	3	2	0	3	8
OG0002955	2	1	3	2	8
OG0002956	1	3	3	1	8
OG0002957	3	2	1	2	8
OG0002958	2	2	3	1	8
OG0002959	1	2	2	3	8
OG0002960	1	4	2	1	8
OG0002961	1	1	2	4	8
OG0002962	2	0	4	2	8
OG0002963	1	4	1	2	8
OG0002964	2	1	2	3	8
OG0002965	1	0	0	7	8
OG0002966	3	2	2	1	8
OG0002967	1	1	4	2	8
OG0002968	1	2	2	3	8
OG0002969	1	1	1	5	8
OG0002970	1	2	3	2	8
OG0002971	1	2	3	2	8
OG0002972	1	0	0	7	8
OG0002973	2	3	2	1	8
OG0002974	1	2	3	2	8
OG0002975	1	2	3	2	8
OG0002976	1	4	1	2	8
OG0002977	1	5	1	1	8
OG0002978	1	2	1	4	8
OG0002979	1	5	1	1	8
OG0002980	1	0	0	7	8
OG0002981	1	0	0	7	8
OG0002982	2	3	1	2	8
OG0002983	2	1	3	2	8
OG0002984	2	0	0	6	8
OG0002985	1	3	0	4	8
OG0002986	1	1	1	5	8
OG0002987	1	1	2	4	8
OG0002988	2	2	1	3	8
OG0002989	2	0	2	4	8
OG0002990	1	0	0	7	8
OG0002991	1	2	1	4	8
OG0002992	2	4	1	1	8
OG0002993	1	4	2	1	8
OG0002994	1	5	1	1	8
OG0002995	1	0	0	7	8
OG0002996	2	2	3	1	8
OG0002997	2	4	0	2	8
OG0002998	2	1	3	2	8
OG0002999	1	2	4	1	8
OG0003000	1	3	1	3	8
OG0003001	1	1	4	2	8
OG0003002	1	3	2	2	8
OG0003003	2	2	1	3	8
OG0003004	2	1	1	4	8
OG0003005	1	4	2	1	8
OG0003006	1	3	1	3	8
OG0003007	1	1	5	1	8
OG0003008	2	2	1	3	8
OG0003009	1	2	1	4	8
OG0003010	2	6	0	0	8
OG0003011	1	2	4	1	8
OG0003012	1	3	2	2	8
OG0003013	2	3	1	2	8
OG0003014	2	2	1	3	8
OG0003015	1	5	1	1	8
OG0003016	1	4	1	2	8
OG0003017	1	1	1	5	8
OG0003018	1	3	1	3	8
OG0003019	1	0	0	7	8
OG0003020	1	1	2	4	8
OG0003021	1	3	1	3	8
OG0003022	2	4	1	1	8
OG0003023	2	4	1	1	8
OG0003024	1	4	1	2	8
OG0003025	1	3	3	1	8
OG0003026	1	6	0	1	8
OG0003027	1	2	4	1	8
OG0003028	2	4	1	1	8
OG0003029	2	2	0	4	8
OG0003030	1	2	1	4	8
OG0003031	3	1	3	1	8
OG0003032	1	6	0	1	8
OG0003033	1	6	0	1	8
OG0003034	1	2	2	3	8
OG0003035	1	1	5	1	8
OG0003036	1	2	2	3	8
OG0003037	1	2	1	4	8
OG0003038	1	2	4	1	8
OG0003039	1	1	2	4	8
OG0003040	1	3	2	2	8
OG0003041	1	2	4	1	8
OG0003042	1	5	1	1	8
OG0003043	1	2	3	2	8
OG0003044	1	4	2	1	8
OG0003045	1	1	5	1	8
OG0003046	1	5	1	1	8
OG0003047	1	1	5	1	8
OG0003048	2	1	2	3	8
OG0003049	1	5	1	1	8
OG0003050	2	3	2	1	8
OG0003051	1	4	1	2	8
OG0003052	1	2	1	4	8
OG0003053	1	1	2	4	8
OG0003054	1	1	4	2	8
OG0003055	1	2	1	4	8
OG0003056	1	2	1	4	8
OG0003057	1	3	4	0	8
OG0003058	1	1	4	2	8
OG0003059	1	4	2	1	8
OG0003060	1	2	1	4	8
OG0003061	2	2	0	4	8
OG0003062	1	0	0	7	8
OG0003063	1	4	0	3	8
OG0003064	1	4	2	1	8
OG0003065	1	0	0	7	8
OG0003066	1	1	4	2	8
OG0003067	0	8	0	0	8
OG0003068	0	8	0	0	8
OG0003069	0	8	0	0	8
OG0003070	0	8	0	0	8
OG0003071	0	8	0	0	8
OG0003072	0	8	0	0	8
OG0003073	0	8	0	0	8
OG0003074	0	8	0	0	8
OG0003075	0	8	0	0	8
OG0003076	0	8	0	0	8
OG0003077	0	8	0	0	8
OG0003078	0	8	0	0	8
OG0003079	0	8	0	0	8
OG0003080	0	8	0	0	8
OG0003081	0	8	0	0	8
OG0003082	0	8	0	0	8
OG0003083	0	8	0	0	8
OG0003084	0	8	0	0	8
OG0003085	0	8	0	0	8
OG0003086	0	8	0	0	8
OG0003087	0	8	0	0	8
OG0003088	0	7	0	1	8
OG0003089	0	8	0	0	8
OG0003090	0	8	0	0	8
OG0003091	0	8	0	0	8
OG0003092	0	8	0	0	8
OG0003093	0	8	0	0	8
OG0003094	0	8	0	0	8
OG0003095	0	8	0	0	8
OG0003096	0	4	0	4	8
OG0003097	0	8	0	0	8
OG0003098	0	8	0	0	8
OG0003099	0	8	0	0	8
OG0003100	0	8	0	0	8
OG0003101	0	8	0	0	8
OG0003102	0	8	0	0	8
OG0003103	0	8	0	0	8
OG0003104	0	8	0	0	8
OG0003105	0	8	0	0	8
OG0003106	0	8	0	0	8
OG0003107	0	8	0	0	8
OG0003108	0	8	0	0	8
OG0003109	0	8	0	0	8
OG0003110	0	8	0	0	8
OG0003111	0	8	0	0	8
OG0003112	0	8	0	0	8
OG0003113	0	8	0	0	8
OG0003114	0	8	0	0	8
OG0003115	0	8	0	0	8
OG0003116	0	8	0	0	8
OG0003117	0	8	0	0	8
OG0003118	0	8	0	0	8
OG0003119	0	8	0	0	8
OG0003120	0	8	0	0	8
OG0003121	0	8	0	0	8
OG0003122	0	8	0	0	8
OG0003123	0	8	0	0	8
OG0003124	0	8	0	0	8
OG0003125	0	8	0	0	8
OG0003126	0	8	0	0	8
OG0003127	0	8	0	0	8
OG0003128	0	8	0	0	8
OG0003129	0	8	0	0	8
OG0003130	0	8	0	0	8
OG0003131	0	8	0	0	8
OG0003132	0	8	0	0	8
OG0003133	0	8	0	0	8
OG0003134	0	8	0	0	8
OG0003135	0	7	1	0	8
OG0003136	0	8	0	0	8
OG0003137	0	8	0	0	8
OG0003138	0	2	0	6	8
OG0003139	0	8	0	0	8
OG0003140	0	1	0	7	8
OG0003141	0	8	0	0	8
OG0003142	0	8	0	0	8
OG0003143	0	7	0	1	8
OG0003144	0	2	0	6	8
OG0003145	0	8	0	0	8
OG0003146	0	8	0	0	8
OG0003147	0	8	0	0	8
OG0003148	0	8	0	0	8
OG0003149	0	8	0	0	8
OG0003150	0	8	0	0	8
OG0003151	0	8	0	0	8
OG0003152	0	1	5	2	8
OG0003153	0	2	0	6	8
OG0003154	0	8	0	0	8
OG0003155	0	0	8	0	8
OG0003156	0	0	8	0	8
OG0003157	0	0	8	0	8
OG0003158	0	0	8	0	8
OG0003159	0	0	8	0	8
OG0003160	0	0	8	0	8
OG0003161	0	0	8	0	8
OG0003162	0	0	8	0	8
OG0003163	0	0	8	0	8
OG0003164	0	0	8	0	8
OG0003165	0	0	8	0	8
OG0003166	0	0	8	0	8
OG0003167	0	0	8	0	8
OG0003168	0	0	8	0	8
OG0003169	0	0	8	0	8
OG0003170	0	0	8	0	8
OG0003171	0	0	8	0	8
OG0003172	0	0	8	0	8
OG0003173	0	0	8	0	8
OG0003174	0	0	8	0	8
OG0003175	0	0	8	0	8
OG0003176	0	0	8	0	8
OG0003177	0	0	8	0	8
OG0003178	0	0	8	0	8
OG0003179	0	0	8	0	8
OG0003180	0	0	0	8	8
OG0003181	0	0	0	8	8
OG0003182	0	0	0	8	8
OG0003183	0	0	0	8	8
OG0003184	0	0	0	8	8
OG0003185	0	0	0	8	8
OG0003186	0	0	0	8	8
OG0003187	0	0	0	8	8
OG0003188	0	0	0	8	8
OG0003189	0	0	0	8	8
OG0003190	0	0	0	8	8
OG0003191	0	0	0	8	8
OG0003192	0	0	0	8	8
OG0003193	0	0	0	8	8
OG0003194	0	0	0	8	8
OG0003195	0	0	0	8	8
OG0003196	0	0	0	8	8
OG0003197	0	0	0	8	8
OG0003198	0	0	0	8	8
OG0003199	0	0	0	8	8
OG0003200	0	0	0	8	8
OG0003201	0	0	0	8	8
OG0003202	0	0	0	8	8
OG0003203	0	0	0	8	8
OG0003204	0	0	0	8	8
OG0003205	0	0	0	8	8
OG0003206	0	0	0	8	8
OG0003207	0	0	0	8	8
OG0003208	0	0	0	8	8
OG0003209	0	0	0	8	8
OG0003210	0	0	0	8	8
OG0003211	0	0	0	8	8
OG0003212	0	0	0	8	8
OG0003213	0	0	0	8	8
OG0003214	0	0	0	8	8
OG0003215	0	0	0	8	8
OG0003216	0	0	0	8	8
OG0003217	0	0	0	8	8
OG0003218	0	0	0	8	8
OG0003219	0	0	0	8	8
OG0003220	0	0	0	8	8
OG0003221	0	0	0	8	8
OG0003222	0	0	0	8	8
OG0003223	0	0	0	8	8
OG0003224	0	0	0	8	8
OG0003225	0	0	0	8	8
OG0003226	0	0	0	8	8
OG0003227	0	0	0	8	8
OG0003228	0	0	0	8	8
OG0003229	0	0	0	8	8
OG0003230	0	0	0	8	8
OG0003231	0	0	0	8	8
OG0003232	0	0	0	8	8
OG0003233	0	0	0	8	8
OG0003234	0	0	0	8	8
OG0003235	0	0	0	8	8
OG0003236	0	0	0	8	8
OG0003237	0	0	0	8	8
OG0003238	2	2	2	1	7
OG0003239	7	0	0	0	7
OG0003240	2	3	1	1	7
OG0003241	4	1	1	1	7
OG0003242	3	0	0	4	7
OG0003243	5	0	1	1	7
OG0003244	7	0	0	0	7
OG0003245	3	0	0	4	7
OG0003246	5	0	1	1	7
OG0003247	4	1	1	1	7
OG0003248	2	2	1	2	7
OG0003249	7	0	0	0	7
OG0003250	7	0	0	0	7
OG0003251	2	2	1	2	7
OG0003252	3	1	2	1	7
OG0003253	2	4	0	1	7
OG0003254	4	1	1	1	7
OG0003255	5	0	0	2	7
OG0003256	7	0	0	0	7
OG0003257	1	0	0	6	7
OG0003258	7	0	0	0	7
OG0003259	7	0	0	0	7
OG0003260	3	1	1	2	7
OG0003261	4	2	0	1	7
OG0003262	3	2	1	1	7
OG0003263	3	2	0	2	7
OG0003264	4	0	0	3	7
OG0003265	4	1	1	1	7
OG0003266	2	2	1	2	7
OG0003267	2	2	1	2	7
OG0003268	6	0	0	1	7
OG0003269	4	1	1	1	7
OG0003270	6	1	0	0	7
OG0003271	5	0	0	2	7
OG0003272	7	0	0	0	7
OG0003273	4	0	0	3	7
OG0003274	7	0	0	0	7
OG0003275	4	0	0	3	7
OG0003276	7	0	0	0	7
OG0003277	5	2	0	0	7
OG0003278	3	2	1	1	7
OG0003279	7	0	0	0	7
OG0003280	4	1	1	1	7
OG0003281	2	1	2	2	7
OG0003282	7	0	0	0	7
OG0003283	3	1	1	2	7
OG0003284	6	0	0	1	7
OG0003285	4	0	2	1	7
OG0003286	6	0	0	1	7
OG0003287	3	1	2	1	7
OG0003288	7	0	0	0	7
OG0003289	7	0	0	0	7
OG0003290	2	1	1	3	7
OG0003291	7	0	0	0	7
OG0003292	3	2	1	1	7
OG0003293	7	0	0	0	7
OG0003294	3	0	0	4	7
OG0003295	6	0	0	1	7
OG0003296	2	3	1	1	7
OG0003297	4	1	1	1	7
OG0003298	7	0	0	0	7
OG0003299	4	1	1	1	7
OG0003300	2	2	0	3	7
OG0003301	7	0	0	0	7
OG0003302	1	0	0	6	7
OG0003303	3	1	1	2	7
OG0003304	5	0	1	1	7
OG0003305	3	1	1	2	7
OG0003306	2	1	3	1	7
OG0003307	2	3	1	1	7
OG0003308	4	1	1	1	7
OG0003309	6	0	0	1	7
OG0003310	7	0	0	0	7
OG0003311	7	0	0	0	7
OG0003312	3	1	1	2	7
OG0003313	5	0	0	2	7
OG0003314	4	1	1	1	7
OG0003315	2	1	2	2	7
OG0003316	7	0	0	0	7
OG0003317	6	0	0	1	7
OG0003318	4	1	1	1	7
OG0003319	2	3	1	1	7
OG0003320	2	1	3	1	7
OG0003321	3	2	1	1	7
OG0003322	7	0	0	0	7
OG0003323	7	0	0	0	7
OG0003324	7	0	0	0	7
OG0003325	2	1	3	1	7
OG0003326	7	0	0	0	7
OG0003327	2	2	2	1	7
OG0003328	7	0	0	0	7
OG0003329	1	0	0	6	7
OG0003330	4	0	0	3	7
OG0003331	3	1	1	2	7
OG0003332	6	1	0	0	7
OG0003333	3	2	1	1	7
OG0003334	6	0	0	1	7
OG0003335	7	0	0	0	7
OG0003336	2	3	1	1	7
OG0003337	7	0	0	0	7
OG0003338	6	0	0	1	7
OG0003339	4	1	1	1	7
OG0003340	2	1	3	1	7
OG0003341	2	1	0	4	7
OG0003342	3	2	1	1	7
OG0003343	3	0	0	4	7
OG0003344	3	2	1	1	7
OG0003345	2	1	2	2	7
OG0003346	2	2	2	1	7
OG0003347	2	2	2	1	7
OG0003348	2	2	2	1	7
OG0003349	2	3	1	1	7
OG0003350	1	0	0	6	7
OG0003351	3	1	1	2	7
OG0003352	2	1	2	2	7
OG0003353	2	2	2	1	7
OG0003354	7	0	0	0	7
OG0003355	1	3	1	2	7
OG0003356	4	1	1	1	7
OG0003357	4	0	0	3	7
OG0003358	3	1	1	2	7
OG0003359	5	1	0	1	7
OG0003360	6	0	0	1	7
OG0003361	1	0	0	6	7
OG0003362	3	1	1	2	7
OG0003363	2	1	3	1	7
OG0003364	7	0	0	0	7
OG0003365	5	0	0	2	7
OG0003366	7	0	0	0	7
OG0003367	1	4	2	0	7
OG0003368	2	2	1	2	7
OG0003369	4	2	0	1	7
OG0003370	5	0	0	2	7
OG0003371	7	0	0	0	7
OG0003372	2	1	0	4	7
OG0003373	7	0	0	0	7
OG0003374	5	0	0	2	7
OG0003375	3	1	1	2	7
OG0003376	2	1	3	1	7
OG0003377	7	0	0	0	7
OG0003378	7	0	0	0	7
OG0003379	2	4	0	1	7
OG0003380	7	0	0	0	7
OG0003381	2	0	1	4	7
OG0003382	2	1	2	2	7
OG0003383	7	0	0	0	7
OG0003384	5	0	0	2	7
OG0003385	7	0	0	0	7
OG0003386	6	0	0	1	7
OG0003387	6	0	0	1	7
OG0003388	4	0	0	3	7
OG0003389	4	1	1	1	7
OG0003390	3	1	2	1	7
OG0003391	4	0	0	3	7
OG0003392	3	2	1	1	7
OG0003393	4	1	0	2	7
OG0003394	3	1	0	3	7
OG0003395	4	0	0	3	7
OG0003396	2	1	1	3	7
OG0003397	4	1	1	1	7
OG0003398	4	1	1	1	7
OG0003399	7	0	0	0	7
OG0003400	3	2	1	1	7
OG0003401	3	2	1	1	7
OG0003402	4	1	1	1	7
OG0003403	5	0	0	2	7
OG0003404	3	2	1	1	7
OG0003405	4	0	0	3	7
OG0003406	3	3	0	1	7
OG0003407	2	2	1	2	7
OG0003408	4	1	1	1	7
OG0003409	7	0	0	0	7
OG0003410	1	0	0	6	7
OG0003411	3	0	1	3	7
OG0003412	2	2	0	3	7
OG0003413	7	0	0	0	7
OG0003414	2	1	0	4	7
OG0003415	7	0	0	0	7
OG0003416	7	0	0	0	7
OG0003417	2	2	1	2	7
OG0003418	2	1	3	1	7
OG0003419	2	2	1	2	7
OG0003420	2	1	2	2	7
OG0003421	6	0	0	1	7
OG0003422	2	2	2	1	7
OG0003423	4	1	1	1	7
OG0003424	3	1	1	2	7
OG0003425	6	0	0	1	7
OG0003426	6	0	0	1	7
OG0003427	3	1	0	3	7
OG0003428	7	0	0	0	7
OG0003429	2	2	1	2	7
OG0003430	6	0	0	1	7
OG0003431	4	0	0	3	7
OG0003432	2	2	1	2	7
OG0003433	2	1	1	3	7
OG0003434	3	3	0	1	7
OG0003435	3	1	1	2	7
OG0003436	2	1	3	1	7
OG0003437	3	1	1	2	7
OG0003438	2	1	3	1	7
OG0003439	3	1	2	1	7
OG0003440	3	2	1	1	7
OG0003441	4	1	1	1	7
OG0003442	1	0	0	6	7
OG0003443	3	1	2	1	7
OG0003444	2	3	1	1	7
OG0003445	7	0	0	0	7
OG0003446	2	3	1	1	7
OG0003447	3	2	1	1	7
OG0003448	2	3	1	1	7
OG0003449	2	0	2	3	7
OG0003450	3	0	3	1	7
OG0003451	2	3	1	1	7
OG0003452	2	1	1	3	7
OG0003453	4	1	0	2	7
OG0003454	2	2	1	2	7
OG0003455	2	2	1	2	7
OG0003456	3	0	0	4	7
OG0003457	2	0	0	5	7
OG0003458	4	0	0	3	7
OG0003459	2	1	3	1	7
OG0003460	2	1	1	3	7
OG0003461	4	0	0	3	7
OG0003462	2	1	2	2	7
OG0003463	2	1	1	3	7
OG0003464	2	2	2	1	7
OG0003465	7	0	0	0	7
OG0003466	2	1	3	1	7
OG0003467	2	1	3	1	7
OG0003468	3	2	1	1	7
OG0003469	7	0	0	0	7
OG0003470	2	2	0	3	7
OG0003471	7	0	0	0	7
OG0003472	3	2	1	1	7
OG0003473	7	0	0	0	7
OG0003474	2	2	1	2	7
OG0003475	3	1	1	2	7
OG0003476	3	1	1	2	7
OG0003477	2	4	0	1	7
OG0003478	7	0	0	0	7
OG0003479	2	2	2	1	7
OG0003480	2	2	2	1	7
OG0003481	3	0	0	4	7
OG0003482	4	1	1	1	7
OG0003483	3	2	1	1	7
OG0003484	7	0	0	0	7
OG0003485	3	1	1	2	7
OG0003486	1	0	0	6	7
OG0003487	2	5	0	0	7
OG0003488	7	0	0	0	7
OG0003489	5	1	0	1	7
OG0003490	1	1	0	5	7
OG0003491	3	0	1	3	7
OG0003492	2	2	1	2	7
OG0003493	7	0	0	0	7
OG0003494	2	2	1	2	7
OG0003495	7	0	0	0	7
OG0003496	7	0	0	0	7
OG0003497	6	1	0	0	7
OG0003498	7	0	0	0	7
OG0003499	3	3	0	1	7
OG0003500	3	2	1	1	7
OG0003501	3	1	1	2	7
OG0003502	4	0	0	3	7
OG0003503	3	2	0	2	7
OG0003504	2	0	3	2	7
OG0003505	6	1	0	0	7
OG0003506	7	0	0	0	7
OG0003507	3	2	1	1	7
OG0003508	7	0	0	0	7
OG0003509	5	0	0	2	7
OG0003510	2	3	0	2	7
OG0003511	6	0	0	1	7
OG0003512	1	2	0	4	7
OG0003513	7	0	0	0	7
OG0003514	2	1	1	3	7
OG0003515	6	0	0	1	7
OG0003516	7	0	0	0	7
OG0003517	2	3	1	1	7
OG0003518	5	1	0	1	7
OG0003519	3	1	2	1	7
OG0003520	7	0	0	0	7
OG0003521	3	3	0	1	7
OG0003522	2	1	2	2	7
OG0003523	3	1	1	2	7
OG0003524	2	2	2	1	7
OG0003525	3	2	1	1	7
OG0003526	2	0	0	5	7
OG0003527	4	1	1	1	7
OG0003528	3	0	0	4	7
OG0003529	1	0	0	6	7
OG0003530	2	4	0	1	7
OG0003531	5	0	1	1	7
OG0003532	1	1	5	0	7
OG0003533	7	0	0	0	7
OG0003534	4	1	1	1	7
OG0003535	2	2	2	1	7
OG0003536	2	0	0	5	7
OG0003537	2	3	1	1	7
OG0003538	3	4	0	0	7
OG0003539	3	2	1	1	7
OG0003540	2	0	2	3	7
OG0003541	2	1	3	1	7
OG0003542	7	0	0	0	7
OG0003543	6	0	0	1	7
OG0003544	3	0	0	4	7
OG0003545	3	1	1	2	7
OG0003546	5	0	0	2	7
OG0003547	6	0	0	1	7
OG0003548	7	0	0	0	7
OG0003549	2	0	0	5	7
OG0003550	7	0	0	0	7
OG0003551	4	0	0	3	7
OG0003552	2	1	3	1	7
OG0003553	5	0	0	2	7
OG0003554	3	1	2	1	7
OG0003555	1	0	0	6	7
OG0003556	3	0	0	4	7
OG0003557	2	2	2	1	7
OG0003558	2	1	2	2	7
OG0003559	7	0	0	0	7
OG0003560	5	0	0	2	7
OG0003561	3	3	0	1	7
OG0003562	5	0	0	2	7
OG0003563	7	0	0	0	7
OG0003564	4	2	0	1	7
OG0003565	4	1	1	1	7
OG0003566	1	0	0	6	7
OG0003567	2	1	1	3	7
OG0003568	2	2	1	2	7
OG0003569	2	3	1	1	7
OG0003570	7	0	0	0	7
OG0003571	4	1	0	2	7
OG0003572	1	3	1	2	7
OG0003573	1	0	0	6	7
OG0003574	3	0	0	4	7
OG0003575	7	0	0	0	7
OG0003576	4	1	1	1	7
OG0003577	3	1	1	2	7
OG0003578	5	0	0	2	7
OG0003579	6	0	0	1	7
OG0003580	7	0	0	0	7
OG0003581	2	2	1	2	7
OG0003582	2	0	0	5	7
OG0003583	2	1	1	3	7
OG0003584	7	0	0	0	7
OG0003585	7	0	0	0	7
OG0003586	1	0	0	6	7
OG0003587	2	1	2	2	7
OG0003588	3	0	0	4	7
OG0003589	2	3	0	2	7
OG0003590	1	2	3	1	7
OG0003591	3	0	0	4	7
OG0003592	2	1	1	3	7
OG0003593	1	0	0	6	7
OG0003594	3	1	1	2	7
OG0003595	1	0	0	6	7
OG0003596	2	4	0	1	7
OG0003597	1	0	0	6	7
OG0003598	2	3	0	2	7
OG0003599	3	2	0	2	7
OG0003600	3	2	1	1	7
OG0003601	2	0	0	5	7
OG0003602	3	0	0	4	7
OG0003603	3	0	1	3	7
OG0003604	7	0	0	0	7
OG0003605	2	2	2	1	7
OG0003606	3	1	1	2	7
OG0003607	3	0	0	4	7
OG0003608	2	2	1	2	7
OG0003609	1	0	0	6	7
OG0003610	1	2	2	2	7
OG0003611	2	1	2	2	7
OG0003612	3	0	0	4	7
OG0003613	7	0	0	0	7
OG0003614	1	1	1	4	7
OG0003615	4	1	1	1	7
OG0003616	1	2	3	1	7
OG0003617	1	1	3	2	7
OG0003618	1	6	0	0	7
OG0003619	1	1	4	1	7
OG0003620	1	0	0	6	7
OG0003621	2	2	2	1	7
OG0003622	1	1	2	3	7
OG0003623	2	1	2	2	7
OG0003624	3	1	2	1	7
OG0003625	3	0	0	4	7
OG0003626	2	2	0	3	7
OG0003627	1	1	4	1	7
OG0003628	1	5	0	1	7
OG0003629	2	1	2	2	7
OG0003630	2	0	4	1	7
OG0003631	7	0	0	0	7
OG0003632	1	3	3	0	7
OG0003633	1	3	1	2	7
OG0003634	1	1	3	2	7
OG0003635	1	0	0	6	7
OG0003636	1	1	3	2	7
OG0003637	2	0	0	5	7
OG0003638	1	2	1	3	7
OG0003639	2	1	3	1	7
OG0003640	1	3	2	1	7
OG0003641	1	3	2	1	7
OG0003642	2	0	1	4	7
OG0003643	3	0	0	4	7
OG0003644	1	1	3	2	7
OG0003645	3	1	0	3	7
OG0003646	1	2	2	2	7
OG0003647	2	1	2	2	7
OG0003648	1	1	4	1	7
OG0003649	1	2	1	3	7
OG0003650	2	3	0	2	7
OG0003651	1	3	2	1	7
OG0003652	3	0	0	4	7
OG0003653	1	0	0	6	7
OG0003654	2	0	0	5	7
OG0003655	1	0	0	6	7
OG0003656	1	1	4	1	7
OG0003657	1	0	0	6	7
OG0003658	1	1	1	4	7
OG0003659	2	1	3	1	7
OG0003660	1	1	4	1	7
OG0003661	1	1	4	1	7
OG0003662	1	4	1	1	7
OG0003663	1	0	5	1	7
OG0003664	2	1	2	2	7
OG0003665	1	2	0	4	7
OG0003666	1	0	0	6	7
OG0003667	1	2	3	1	7
OG0003668	1	3	1	2	7
OG0003669	1	5	0	1	7
OG0003670	1	1	2	3	7
OG0003671	1	2	1	3	7
OG0003672	1	3	1	2	7
OG0003673	1	3	2	1	7
OG0003674	2	3	1	1	7
OG0003675	6	0	0	1	7
OG0003676	1	2	1	3	7
OG0003677	2	0	0	5	7
OG0003678	2	0	0	5	7
OG0003679	1	3	2	1	7
OG0003680	2	1	1	3	7
OG0003681	3	1	2	1	7
OG0003682	1	1	4	1	7
OG0003683	2	2	1	2	7
OG0003684	1	3	2	1	7
OG0003685	1	3	1	2	7
OG0003686	1	1	1	4	7
OG0003687	1	4	1	1	7
OG0003688	1	2	3	1	7
OG0003689	4	0	0	3	7
OG0003690	1	1	3	2	7
OG0003691	1	1	4	1	7
OG0003692	1	2	1	3	7
OG0003693	1	1	2	3	7
OG0003694	1	2	1	3	7
OG0003695	1	1	2	3	7
OG0003696	2	1	2	2	7
OG0003697	7	0	0	0	7
OG0003698	1	1	4	1	7
OG0003699	1	2	2	2	7
OG0003700	1	0	0	6	7
OG0003701	1	1	4	1	7
OG0003702	1	1	4	1	7
OG0003703	1	2	2	2	7
OG0003704	1	2	1	3	7
OG0003705	2	1	2	2	7
OG0003706	1	1	4	1	7
OG0003707	1	0	0	6	7
OG0003708	1	0	0	6	7
OG0003709	2	1	1	3	7
OG0003710	1	2	1	3	7
OG0003711	1	2	3	1	7
OG0003712	1	0	0	6	7
OG0003713	2	3	0	2	7
OG0003714	1	1	1	4	7
OG0003715	1	2	3	1	7
OG0003716	2	1	1	3	7
OG0003717	1	2	2	2	7
OG0003718	2	1	2	2	7
OG0003719	2	1	2	2	7
OG0003720	1	1	1	4	7
OG0003721	1	4	1	1	7
OG0003722	2	3	0	2	7
OG0003723	2	2	1	2	7
OG0003724	1	2	1	3	7
OG0003725	1	2	3	1	7
OG0003726	1	0	0	6	7
OG0003727	2	5	0	0	7
OG0003728	2	0	0	5	7
OG0003729	3	0	0	4	7
OG0003730	2	3	1	1	7
OG0003731	1	2	1	3	7
OG0003732	1	2	1	3	7
OG0003733	1	0	1	5	7
OG0003734	1	2	1	3	7
OG0003735	1	2	2	2	7
OG0003736	7	0	0	0	7
OG0003737	2	1	3	1	7
OG0003738	2	0	0	5	7
OG0003739	1	2	1	3	7
OG0003740	1	2	1	3	7
OG0003741	1	1	3	2	7
OG0003742	2	2	2	1	7
OG0003743	1	4	1	1	7
OG0003744	1	1	0	5	7
OG0003745	2	1	1	3	7
OG0003746	1	2	0	4	7
OG0003747	1	2	3	1	7
OG0003748	1	0	0	6	7
OG0003749	1	2	1	3	7
OG0003750	2	1	2	2	7
OG0003751	1	2	1	3	7
OG0003752	1	4	1	1	7
OG0003753	2	1	2	2	7
OG0003754	1	2	2	2	7
OG0003755	1	3	2	1	7
OG0003756	1	2	1	3	7
OG0003757	1	2	1	3	7
OG0003758	1	4	1	1	7
OG0003759	1	2	2	2	7
OG0003760	1	2	2	2	7
OG0003761	1	3	1	2	7
OG0003762	1	4	1	1	7
OG0003763	1	0	0	6	7
OG0003764	3	0	0	4	7
OG0003765	1	1	1	4	7
OG0003766	1	1	1	4	7
OG0003767	1	2	3	1	7
OG0003768	1	2	3	1	7
OG0003769	1	0	5	1	7
OG0003770	2	0	0	5	7
OG0003771	1	4	1	1	7
OG0003772	2	2	1	2	7
OG0003773	1	1	3	2	7
OG0003774	2	2	2	1	7
OG0003775	1	2	1	3	7
OG0003776	2	2	1	2	7
OG0003777	2	3	1	1	7
OG0003778	1	1	1	4	7
OG0003779	1	0	0	6	7
OG0003780	2	2	1	2	7
OG0003781	1	2	1	3	7
OG0003782	1	0	0	6	7
OG0003783	1	6	0	0	7
OG0003784	2	0	2	3	7
OG0003785	1	3	2	1	7
OG0003786	1	3	1	2	7
OG0003787	2	3	1	1	7
OG0003788	1	4	1	1	7
OG0003789	3	1	2	1	7
OG0003790	6	0	0	1	7
OG0003791	1	1	2	3	7
OG0003792	1	3	1	2	7
OG0003793	1	1	4	1	7
OG0003794	1	4	1	1	7
OG0003795	1	2	3	1	7
OG0003796	1	2	3	1	7
OG0003797	1	1	3	2	7
OG0003798	3	2	1	1	7
OG0003799	2	1	2	2	7
OG0003800	2	1	1	3	7
OG0003801	1	3	1	2	7
OG0003802	1	4	1	1	7
OG0003803	1	1	4	1	7
OG0003804	2	2	2	1	7
OG0003805	1	2	3	1	7
OG0003806	1	2	2	2	7
OG0003807	2	4	0	1	7
OG0003808	1	4	1	1	7
OG0003809	2	5	0	0	7
OG0003810	7	0	0	0	7
OG0003811	1	3	2	1	7
OG0003812	1	1	1	4	7
OG0003813	2	2	2	1	7
OG0003814	1	2	3	1	7
OG0003815	1	3	2	1	7
OG0003816	2	1	2	2	7
OG0003817	3	1	1	2	7
OG0003818	1	1	1	4	7
OG0003819	1	2	2	2	7
OG0003820	1	2	3	1	7
OG0003821	1	2	3	1	7
OG0003822	1	1	4	1	7
OG0003823	1	2	3	1	7
OG0003824	1	0	0	6	7
OG0003825	1	3	1	2	7
OG0003826	1	1	4	1	7
OG0003827	1	1	3	2	7
OG0003828	1	2	3	1	7
OG0003829	2	0	0	5	7
OG0003830	1	3	2	1	7
OG0003831	1	2	2	2	7
OG0003832	2	1	2	2	7
OG0003833	1	0	0	6	7
OG0003834	2	2	1	2	7
OG0003835	1	3	1	2	7
OG0003836	1	2	3	1	7
OG0003837	2	2	2	1	7
OG0003838	1	1	2	3	7
OG0003839	1	5	0	1	7
OG0003840	2	1	0	4	7
OG0003841	1	1	4	1	7
OG0003842	1	4	1	1	7
OG0003843	1	4	1	1	7
OG0003844	3	2	1	1	7
OG0003845	2	1	2	2	7
OG0003846	1	2	1	3	7
OG0003847	1	1	4	1	7
OG0003848	1	2	1	3	7
OG0003849	1	3	1	2	7
OG0003850	1	5	0	1	7
OG0003851	1	3	1	2	7
OG0003852	3	1	1	2	7
OG0003853	1	6	0	0	7
OG0003854	2	3	0	2	7
OG0003855	1	2	3	1	7
OG0003856	1	2	1	3	7
OG0003857	1	3	2	1	7
OG0003858	2	2	2	1	7
OG0003859	1	2	1	3	7
OG0003860	1	3	1	2	7
OG0003861	2	2	1	2	7
OG0003862	1	3	2	1	7
OG0003863	1	2	1	3	7
OG0003864	1	2	3	1	7
OG0003865	3	1	0	3	7
OG0003866	1	1	2	3	7
OG0003867	2	1	3	1	7
OG0003868	1	1	4	1	7
OG0003869	1	1	3	2	7
OG0003870	1	1	0	5	7
OG0003871	1	2	3	1	7
OG0003872	1	4	1	1	7
OG0003873	1	1	2	3	7
OG0003874	1	3	2	1	7
OG0003875	1	1	0	5	7
OG0003876	1	3	2	1	7
OG0003877	1	5	0	1	7
OG0003878	1	2	3	1	7
OG0003879	2	2	1	2	7
OG0003880	2	1	1	3	7
OG0003881	1	5	0	1	7
OG0003882	2	1	3	1	7
OG0003883	1	1	1	4	7
OG0003884	1	2	3	1	7
OG0003885	1	1	4	1	7
OG0003886	1	2	3	1	7
OG0003887	2	0	0	5	7
OG0003888	1	1	2	3	7
OG0003889	2	3	1	1	7
OG0003890	1	3	1	2	7
OG0003891	2	0	0	5	7
OG0003892	1	1	2	3	7
OG0003893	2	1	0	4	7
OG0003894	2	2	1	2	7
OG0003895	1	1	2	3	7
OG0003896	1	2	2	2	7
OG0003897	1	3	2	1	7
OG0003898	1	3	2	1	7
OG0003899	1	1	4	1	7
OG0003900	1	1	4	1	7
OG0003901	2	1	1	3	7
OG0003902	1	4	1	1	7
OG0003903	1	1	0	5	7
OG0003904	1	3	1	2	7
OG0003905	1	4	1	1	7
OG0003906	1	3	2	1	7
OG0003907	1	2	1	3	7
OG0003908	1	2	3	1	7
OG0003909	2	1	1	3	7
OG0003910	1	2	3	1	7
OG0003911	1	4	1	1	7
OG0003912	2	1	2	2	7
OG0003913	1	5	0	1	7
OG0003914	2	2	1	2	7
OG0003915	1	4	1	1	7
OG0003916	1	2	3	1	7
OG0003917	1	2	3	1	7
OG0003918	1	1	2	3	7
OG0003919	1	1	1	4	7
OG0003920	1	1	3	2	7
OG0003921	2	1	3	1	7
OG0003922	1	3	1	2	7
OG0003923	1	1	2	3	7
OG0003924	1	1	1	4	7
OG0003925	1	2	2	2	7
OG0003926	1	2	2	2	7
OG0003927	1	1	2	3	7
OG0003928	1	4	1	1	7
OG0003929	1	1	4	1	7
OG0003930	1	4	1	1	7
OG0003931	2	1	2	2	7
OG0003932	1	3	1	2	7
OG0003933	1	4	1	1	7
OG0003934	1	0	1	5	7
OG0003935	1	2	3	1	7
OG0003936	1	2	3	1	7
OG0003937	1	1	1	4	7
OG0003938	1	3	1	2	7
OG0003939	1	4	1	1	7
OG0003940	1	4	1	1	7
OG0003941	1	0	5	1	7
OG0003942	2	1	1	3	7
OG0003943	1	3	1	2	7
OG0003944	1	3	2	1	7
OG0003945	1	4	1	1	7
OG0003946	1	1	3	2	7
OG0003947	1	2	4	0	7
OG0003948	1	1	4	1	7
OG0003949	1	0	5	1	7
OG0003950	1	5	0	1	7
OG0003951	1	1	3	2	7
OG0003952	1	1	3	2	7
OG0003953	1	3	2	1	7
OG0003954	1	0	0	6	7
OG0003955	1	2	3	1	7
OG0003956	1	2	2	2	7
OG0003957	1	3	1	2	7
OG0003958	2	3	0	2	7
OG0003959	1	1	1	4	7
OG0003960	1	0	0	6	7
OG0003961	2	1	2	2	7
OG0003962	1	3	2	1	7
OG0003963	1	1	4	1	7
OG0003964	1	2	2	2	7
OG0003965	1	2	2	2	7
OG0003966	1	1	1	4	7
OG0003967	3	0	0	4	7
OG0003968	1	1	4	1	7
OG0003969	1	2	2	2	7
OG0003970	1	1	1	4	7
OG0003971	1	1	3	2	7
OG0003972	1	1	1	4	7
OG0003973	1	0	5	1	7
OG0003974	1	1	2	3	7
OG0003975	1	1	4	1	7
OG0003976	2	1	2	2	7
OG0003977	2	2	2	1	7
OG0003978	1	4	0	2	7
OG0003979	1	4	1	1	7
OG0003980	1	3	1	2	7
OG0003981	1	3	0	3	7
OG0003982	1	2	2	2	7
OG0003983	1	2	1	3	7
OG0003984	1	4	1	1	7
OG0003985	1	1	3	2	7
OG0003986	2	1	2	2	7
OG0003987	1	3	2	1	7
OG0003988	1	2	3	1	7
OG0003989	1	1	4	1	7
OG0003990	1	2	3	1	7
OG0003991	1	1	2	3	7
OG0003992	1	1	3	2	7
OG0003993	1	4	1	1	7
OG0003994	1	1	2	3	7
OG0003995	1	1	1	4	7
OG0003996	1	2	2	2	7
OG0003997	1	0	6	0	7
OG0003998	0	7	0	0	7
OG0003999	0	7	0	0	7
OG0004000	0	7	0	0	7
OG0004001	0	7	0	0	7
OG0004002	0	7	0	0	7
OG0004003	0	7	0	0	7
OG0004004	0	7	0	0	7
OG0004005	0	7	0	0	7
OG0004006	0	7	0	0	7
OG0004007	0	7	0	0	7
OG0004008	0	2	0	5	7
OG0004009	0	7	0	0	7
OG0004010	0	7	0	0	7
OG0004011	0	7	0	0	7
OG0004012	0	7	0	0	7
OG0004013	0	7	0	0	7
OG0004014	0	7	0	0	7
OG0004015	0	7	0	0	7
OG0004016	0	7	0	0	7
OG0004017	0	7	0	0	7
OG0004018	0	7	0	0	7
OG0004019	0	7	0	0	7
OG0004020	0	5	1	1	7
OG0004021	0	7	0	0	7
OG0004022	0	7	0	0	7
OG0004023	0	7	0	0	7
OG0004024	0	7	0	0	7
OG0004025	0	7	0	0	7
OG0004026	0	7	0	0	7
OG0004027	0	7	0	0	7
OG0004028	0	7	0	0	7
OG0004029	0	7	0	0	7
OG0004030	0	7	0	0	7
OG0004031	0	7	0	0	7
OG0004032	0	7	0	0	7
OG0004033	0	7	0	0	7
OG0004034	0	7	0	0	7
OG0004035	0	7	0	0	7
OG0004036	0	7	0	0	7
OG0004037	0	7	0	0	7
OG0004038	0	7	0	0	7
OG0004039	0	7	0	0	7
OG0004040	0	7	0	0	7
OG0004041	0	7	0	0	7
OG0004042	0	7	0	0	7
OG0004043	0	7	0	0	7
OG0004044	0	7	0	0	7
OG0004045	0	7	0	0	7
OG0004046	0	7	0	0	7
OG0004047	0	7	0	0	7
OG0004048	0	7	0	0	7
OG0004049	0	7	0	0	7
OG0004050	0	7	0	0	7
OG0004051	0	7	0	0	7
OG0004052	0	7	0	0	7
OG0004053	0	7	0	0	7
OG0004054	0	7	0	0	7
OG0004055	0	7	0	0	7
OG0004056	0	7	0	0	7
OG0004057	0	7	0	0	7
OG0004058	0	7	0	0	7
OG0004059	0	7	0	0	7
OG0004060	0	6	1	0	7
OG0004061	0	7	0	0	7
OG0004062	0	7	0	0	7
OG0004063	0	7	0	0	7
OG0004064	0	7	0	0	7
OG0004065	0	7	0	0	7
OG0004066	0	7	0	0	7
OG0004067	0	7	0	0	7
OG0004068	0	7	0	0	7
OG0004069	0	7	0	0	7
OG0004070	0	7	0	0	7
OG0004071	0	7	0	0	7
OG0004072	0	7	0	0	7
OG0004073	0	3	0	4	7
OG0004074	0	7	0	0	7
OG0004075	0	7	0	0	7
OG0004076	0	7	0	0	7
OG0004077	0	7	0	0	7
OG0004078	0	7	0	0	7
OG0004079	0	7	0	0	7
OG0004080	0	7	0	0	7
OG0004081	0	6	1	0	7
OG0004082	0	7	0	0	7
OG0004083	0	2	3	2	7
OG0004084	0	7	0	0	7
OG0004085	0	7	0	0	7
OG0004086	0	6	1	0	7
OG0004087	0	7	0	0	7
OG0004088	0	5	0	2	7
OG0004089	0	7	0	0	7
OG0004090	0	2	1	4	7
OG0004091	0	0	7	0	7
OG0004092	0	0	7	0	7
OG0004093	0	0	7	0	7
OG0004094	0	0	7	0	7
OG0004095	0	0	7	0	7
OG0004096	0	0	7	0	7
OG0004097	0	0	7	0	7
OG0004098	0	0	7	0	7
OG0004099	0	0	7	0	7
OG0004100	0	0	7	0	7
OG0004101	0	0	7	0	7
OG0004102	0	0	7	0	7
OG0004103	0	0	7	0	7
OG0004104	0	0	7	0	7
OG0004105	0	0	7	0	7
OG0004106	0	0	7	0	7
OG0004107	0	0	7	0	7
OG0004108	0	0	7	0	7
OG0004109	0	0	7	0	7
OG0004110	0	0	7	0	7
OG0004111	0	0	7	0	7
OG0004112	0	0	7	0	7
OG0004113	0	0	7	0	7
OG0004114	0	0	7	0	7
OG0004115	0	0	7	0	7
OG0004116	0	0	7	0	7
OG0004117	0	0	7	0	7
OG0004118	0	0	7	0	7
OG0004119	0	0	7	0	7
OG0004120	0	0	7	0	7
OG0004121	0	0	7	0	7
OG0004122	0	0	7	0	7
OG0004123	0	0	7	0	7
OG0004124	0	0	0	7	7
OG0004125	0	0	0	7	7
OG0004126	0	0	0	7	7
OG0004127	0	0	0	7	7
OG0004128	0	0	0	7	7
OG0004129	0	0	0	7	7
OG0004130	0	0	0	7	7
OG0004131	0	0	0	7	7
OG0004132	0	0	0	7	7
OG0004133	0	0	0	7	7
OG0004134	0	0	0	7	7
OG0004135	0	0	0	7	7
OG0004136	0	0	0	7	7
OG0004137	0	0	0	7	7
OG0004138	0	0	0	7	7
OG0004139	0	0	0	7	7
OG0004140	0	0	0	7	7
OG0004141	0	0	0	7	7
OG0004142	0	0	0	7	7
OG0004143	0	0	0	7	7
OG0004144	0	0	0	7	7
OG0004145	0	0	0	7	7
OG0004146	0	0	0	7	7
OG0004147	0	0	0	7	7
OG0004148	0	0	0	7	7
OG0004149	0	0	0	7	7
OG0004150	0	0	0	7	7
OG0004151	0	0	0	7	7
OG0004152	0	0	0	7	7
OG0004153	0	0	0	7	7
OG0004154	0	0	0	7	7
OG0004155	0	0	0	7	7
OG0004156	0	0	0	7	7
OG0004157	0	0	0	7	7
OG0004158	0	0	0	7	7
OG0004159	0	0	0	7	7
OG0004160	0	0	0	7	7
OG0004161	0	0	0	7	7
OG0004162	0	0	0	7	7
OG0004163	0	0	0	7	7
OG0004164	0	0	0	7	7
OG0004165	0	0	0	7	7
OG0004166	0	0	0	7	7
OG0004167	0	0	0	7	7
OG0004168	0	0	0	7	7
OG0004169	0	0	0	7	7
OG0004170	0	0	0	7	7
OG0004171	0	0	0	7	7
OG0004172	0	0	0	7	7
OG0004173	0	0	0	7	7
OG0004174	0	0	0	7	7
OG0004175	0	0	0	7	7
OG0004176	0	0	0	7	7
OG0004177	0	0	0	7	7
OG0004178	0	0	0	7	7
OG0004179	0	0	0	7	7
OG0004180	0	0	0	7	7
OG0004181	0	0	0	7	7
OG0004182	0	0	0	7	7
OG0004183	0	0	0	7	7
OG0004184	0	0	0	7	7
OG0004185	0	0	0	7	7
OG0004186	0	0	0	7	7
OG0004187	0	0	0	7	7
OG0004188	0	0	0	7	7
OG0004189	0	0	0	7	7
OG0004190	0	0	0	7	7
OG0004191	0	0	0	7	7
OG0004192	0	0	0	7	7
OG0004193	0	0	0	7	7
OG0004194	0	0	0	7	7
OG0004195	2	2	0	2	6
OG0004196	6	0	0	0	6
OG0004197	4	0	0	2	6
OG0004198	2	2	1	1	6
OG0004199	1	5	0	0	6
OG0004200	6	0	0	0	6
OG0004201	2	2	1	1	6
OG0004202	2	2	1	1	6
OG0004203	3	1	1	1	6
OG0004204	5	0	0	1	6
OG0004205	6	0	0	0	6
OG0004206	6	0	0	0	6
OG0004207	2	1	3	0	6
OG0004208	6	0	0	0	6
OG0004209	4	1	0	1	6
OG0004210	2	1	0	3	6
OG0004211	3	1	1	1	6
OG0004212	3	1	1	1	6
OG0004213	2	2	1	1	6
OG0004214	1	4	1	0	6
OG0004215	4	0	0	2	6
OG0004216	2	0	1	3	6
OG0004217	3	1	1	1	6
OG0004218	2	2	0	2	6
OG0004219	6	0	0	0	6
OG0004220	3	1	0	2	6
OG0004221	2	0	1	3	6
OG0004222	6	0	0	0	6
OG0004223	5	0	0	1	6
OG0004224	2	1	2	1	6
OG0004225	4	0	0	2	6
OG0004226	6	0	0	0	6
OG0004227	6	0	0	0	6
OG0004228	2	1	2	1	6
OG0004229	5	0	0	1	6
OG0004230	2	2	0	2	6
OG0004231	2	2	1	1	6
OG0004232	2	1	1	2	6
OG0004233	6	0	0	0	6
OG0004234	5	0	0	1	6
OG0004235	3	1	1	1	6
OG0004236	2	1	2	1	6
OG0004237	3	0	2	1	6
OG0004238	3	2	0	1	6
OG0004239	4	0	1	1	6
OG0004240	2	2	1	1	6
OG0004241	4	1	0	1	6
OG0004242	6	0	0	0	6
OG0004243	6	0	0	0	6
OG0004244	2	2	1	1	6
OG0004245	1	0	0	5	6
OG0004246	2	1	2	1	6
OG0004247	6	0	0	0	6
OG0004248	5	0	0	1	6
OG0004249	2	1	1	2	6
OG0004250	6	0	0	0	6
OG0004251	2	2	1	1	6
OG0004252	3	1	1	1	6
OG0004253	6	0	0	0	6
OG0004254	6	0	0	0	6
OG0004255	2	0	0	4	6
OG0004256	3	1	0	2	6
OG0004257	6	0	0	0	6
OG0004258	2	2	1	1	6
OG0004259	3	1	0	2	6
OG0004260	5	0	0	1	6
OG0004261	2	1	2	1	6
OG0004262	5	0	0	1	6
OG0004263	5	0	0	1	6
OG0004264	6	0	0	0	6
OG0004265	6	0	0	0	6
OG0004266	2	2	1	1	6
OG0004267	2	1	2	1	6
OG0004268	5	0	0	1	6
OG0004269	2	1	1	2	6
OG0004270	2	2	1	1	6
OG0004271	2	0	0	4	6
OG0004272	6	0	0	0	6
OG0004273	3	1	1	1	6
OG0004274	6	0	0	0	6
OG0004275	2	1	1	2	6
OG0004276	6	0	0	0	6
OG0004277	2	2	1	1	6
OG0004278	2	1	2	1	6
OG0004279	6	0	0	0	6
OG0004280	6	0	0	0	6
OG0004281	2	1	2	1	6
OG0004282	4	1	0	1	6
OG0004283	2	1	0	3	6
OG0004284	3	1	0	2	6
OG0004285	6	0	0	0	6
OG0004286	4	0	0	2	6
OG0004287	6	0	0	0	6
OG0004288	5	0	0	1	6
OG0004289	3	1	1	1	6
OG0004290	6	0	0	0	6
OG0004291	3	1	1	1	6
OG0004292	5	0	0	1	6
OG0004293	4	1	0	1	6
OG0004294	2	1	1	2	6
OG0004295	3	1	1	1	6
OG0004296	6	0	0	0	6
OG0004297	1	0	0	5	6
OG0004298	4	1	0	1	6
OG0004299	4	1	0	1	6
OG0004300	4	0	1	1	6
OG0004301	2	1	2	1	6
OG0004302	2	1	1	2	6
OG0004303	3	0	0	3	6
OG0004304	2	1	1	2	6
OG0004305	5	0	0	1	6
OG0004306	3	1	1	1	6
OG0004307	4	0	0	2	6
OG0004308	1	1	3	1	6
OG0004309	6	0	0	0	6
OG0004310	6	0	0	0	6
OG0004311	4	2	0	0	6
OG0004312	2	1	2	1	6
OG0004313	2	1	1	2	6
OG0004314	6	0	0	0	6
OG0004315	6	0	0	0	6
OG0004316	3	2	0	1	6
OG0004317	2	1	2	1	6
OG0004318	3	1	1	1	6
OG0004319	3	1	1	1	6
OG0004320	2	1	1	2	6
OG0004321	3	1	1	1	6
OG0004322	6	0	0	0	6
OG0004323	3	1	1	1	6
OG0004324	2	1	1	2	6
OG0004325	4	0	0	2	6
OG0004326	2	2	1	1	6
OG0004327	6	0	0	0	6
OG0004328	2	1	2	1	6
OG0004329	3	0	0	3	6
OG0004330	4	1	0	1	6
OG0004331	2	1	2	1	6
OG0004332	6	0	0	0	6
OG0004333	6	0	0	0	6
OG0004334	3	1	1	1	6
OG0004335	2	1	2	1	6
OG0004336	6	0	0	0	6
OG0004337	2	2	1	1	6
OG0004338	3	1	1	1	6
OG0004339	2	0	0	4	6
OG0004340	2	1	0	3	6
OG0004341	2	2	1	1	6
OG0004342	6	0	0	0	6
OG0004343	6	0	0	0	6
OG0004344	2	1	1	2	6
OG0004345	6	0	0	0	6
OG0004346	6	0	0	0	6
OG0004347	3	1	1	1	6
OG0004348	3	1	1	1	6
OG0004349	3	1	1	1	6
OG0004350	5	0	0	1	6
OG0004351	5	0	0	1	6
OG0004352	1	1	1	3	6
OG0004353	3	1	1	1	6
OG0004354	4	0	0	2	6
OG0004355	1	0	0	5	6
OG0004356	6	0	0	0	6
OG0004357	3	1	1	1	6
OG0004358	3	1	1	1	6
OG0004359	6	0	0	0	6
OG0004360	6	0	0	0	6
OG0004361	3	2	1	0	6
OG0004362	6	0	0	0	6
OG0004363	3	1	1	1	6
OG0004364	2	1	1	2	6
OG0004365	5	0	0	1	6
OG0004366	3	1	1	1	6
OG0004367	3	2	0	1	6
OG0004368	2	1	2	1	6
OG0004369	6	0	0	0	6
OG0004370	1	0	0	5	6
OG0004371	3	3	0	0	6
OG0004372	2	1	2	1	6
OG0004373	2	2	1	1	6
OG0004374	2	1	2	1	6
OG0004375	3	1	1	1	6
OG0004376	3	0	0	3	6
OG0004377	3	0	0	3	6
OG0004378	2	1	1	2	6
OG0004379	2	0	0	4	6
OG0004380	1	0	0	5	6
OG0004381	3	1	1	1	6
OG0004382	3	0	2	1	6
OG0004383	6	0	0	0	6
OG0004384	5	0	0	1	6
OG0004385	2	2	1	1	6
OG0004386	3	1	1	1	6
OG0004387	6	0	0	0	6
OG0004388	2	2	1	1	6
OG0004389	2	1	2	1	6
OG0004390	2	1	2	1	6
OG0004391	3	2	0	1	6
OG0004392	3	0	0	3	6
OG0004393	2	2	1	1	6
OG0004394	3	3	0	0	6
OG0004395	2	1	1	2	6
OG0004396	5	0	0	1	6
OG0004397	2	2	1	1	6
OG0004398	6	0	0	0	6
OG0004399	2	1	2	1	6
OG0004400	2	2	0	2	6
OG0004401	6	0	0	0	6
OG0004402	2	1	2	1	6
OG0004403	2	1	1	2	6
OG0004404	4	0	0	2	6
OG0004405	2	1	1	2	6
OG0004406	2	1	1	2	6
OG0004407	2	2	1	1	6
OG0004408	2	1	2	1	6
OG0004409	5	0	0	1	6
OG0004410	2	1	1	2	6
OG0004411	5	0	0	1	6
OG0004412	3	0	0	3	6
OG0004413	2	0	0	4	6
OG0004414	5	0	0	1	6
OG0004415	2	1	2	1	6
OG0004416	2	1	2	1	6
OG0004417	2	1	1	2	6
OG0004418	3	0	0	3	6
OG0004419	3	1	1	1	6
OG0004420	3	1	1	1	6
OG0004421	2	1	2	1	6
OG0004422	2	1	2	1	6
OG0004423	5	0	0	1	6
OG0004424	3	0	2	1	6
OG0004425	1	0	0	5	6
OG0004426	5	0	0	1	6
OG0004427	2	1	2	1	6
OG0004428	2	2	1	1	6
OG0004429	3	0	0	3	6
OG0004430	1	0	0	5	6
OG0004431	3	1	1	1	6
OG0004432	6	0	0	0	6
OG0004433	2	1	1	2	6
OG0004434	2	1	2	1	6
OG0004435	2	2	0	2	6
OG0004436	3	1	1	1	6
OG0004437	2	0	0	4	6
OG0004438	2	0	0	4	6
OG0004439	5	0	0	1	6
OG0004440	2	0	0	4	6
OG0004441	2	1	2	1	6
OG0004442	4	1	0	1	6
OG0004443	2	1	2	1	6
OG0004444	2	2	1	1	6
OG0004445	6	0	0	0	6
OG0004446	1	0	0	5	6
OG0004447	2	1	2	1	6
OG0004448	2	0	1	3	6
OG0004449	3	1	1	1	6
OG0004450	2	1	2	1	6
OG0004451	2	2	1	1	6
OG0004452	4	2	0	0	6
OG0004453	3	0	1	2	6
OG0004454	2	2	1	1	6
OG0004455	3	1	1	1	6
OG0004456	2	1	2	1	6
OG0004457	2	1	1	2	6
OG0004458	6	0	0	0	6
OG0004459	2	2	1	1	6
OG0004460	6	0	0	0	6
OG0004461	2	1	2	1	6
OG0004462	5	1	0	0	6
OG0004463	2	1	2	1	6
OG0004464	2	1	2	1	6
OG0004465	2	2	0	2	6
OG0004466	2	2	1	1	6
OG0004467	1	0	0	5	6
OG0004468	2	2	1	1	6
OG0004469	2	2	1	1	6
OG0004470	2	1	1	2	6
OG0004471	2	2	1	1	6
OG0004472	3	3	0	0	6
OG0004473	5	1	0	0	6
OG0004474	6	0	0	0	6
OG0004475	1	2	0	3	6
OG0004476	5	0	0	1	6
OG0004477	6	0	0	0	6
OG0004478	6	0	0	0	6
OG0004479	5	0	0	1	6
OG0004480	2	3	0	1	6
OG0004481	2	1	1	2	6
OG0004482	2	2	1	1	6
OG0004483	4	1	0	1	6
OG0004484	2	2	1	1	6
OG0004485	2	1	1	2	6
OG0004486	2	2	1	1	6
OG0004487	2	1	2	1	6
OG0004488	3	1	1	1	6
OG0004489	3	0	1	2	6
OG0004490	6	0	0	0	6
OG0004491	1	1	1	3	6
OG0004492	5	0	0	1	6
OG0004493	4	2	0	0	6
OG0004494	3	1	0	2	6
OG0004495	2	2	1	1	6
OG0004496	4	1	0	1	6
OG0004497	3	1	1	1	6
OG0004498	2	1	0	3	6
OG0004499	2	1	2	1	6
OG0004500	6	0	0	0	6
OG0004501	5	0	0	1	6
OG0004502	6	0	0	0	6
OG0004503	4	0	1	1	6
OG0004504	2	1	2	1	6
OG0004505	3	1	1	1	6
OG0004506	2	1	1	2	6
OG0004507	2	2	1	1	6
OG0004508	6	0	0	0	6
OG0004509	3	1	1	1	6
OG0004510	3	1	1	1	6
OG0004511	6	0	0	0	6
OG0004512	1	5	0	0	6
OG0004513	6	0	0	0	6
OG0004514	2	2	1	1	6
OG0004515	6	0	0	0	6
OG0004516	2	2	1	1	6
OG0004517	2	1	2	1	6
OG0004518	2	2	1	1	6
OG0004519	6	0	0	0	6
OG0004520	2	0	3	1	6
OG0004521	3	1	1	1	6
OG0004522	5	0	0	1	6
OG0004523	2	1	2	1	6
OG0004524	4	1	0	1	6
OG0004525	2	1	0	3	6
OG0004526	2	2	1	1	6
OG0004527	2	0	0	4	6
OG0004528	2	2	1	1	6
OG0004529	3	1	1	1	6
OG0004530	6	0	0	0	6
OG0004531	3	1	1	1	6
OG0004532	6	0	0	0	6
OG0004533	2	1	2	1	6
OG0004534	3	0	0	3	6
OG0004535	3	1	1	1	6
OG0004536	3	1	1	1	6
OG0004537	2	2	1	1	6
OG0004538	4	1	0	1	6
OG0004539	6	0	0	0	6
OG0004540	3	0	1	2	6
OG0004541	2	1	2	1	6
OG0004542	2	0	0	4	6
OG0004543	3	1	0	2	6
OG0004544	2	2	1	1	6
OG0004545	6	0	0	0	6
OG0004546	2	2	1	1	6
OG0004547	5	0	0	1	6
OG0004548	2	1	1	2	6
OG0004549	3	0	0	3	6
OG0004550	1	0	0	5	6
OG0004551	2	2	1	1	6
OG0004552	1	1	1	3	6
OG0004553	3	3	0	0	6
OG0004554	2	1	1	2	6
OG0004555	2	2	1	1	6
OG0004556	1	0	0	5	6
OG0004557	2	2	1	1	6
OG0004558	2	0	0	4	6
OG0004559	3	0	1	2	6
OG0004560	3	1	0	2	6
OG0004561	2	2	1	1	6
OG0004562	2	2	1	1	6
OG0004563	2	1	1	2	6
OG0004564	1	0	0	5	6
OG0004565	3	1	1	1	6
OG0004566	4	0	0	2	6
OG0004567	1	0	0	5	6
OG0004568	3	1	1	1	6
OG0004569	2	2	1	1	6
OG0004570	4	1	0	1	6
OG0004571	2	2	1	1	6
OG0004572	5	0	0	1	6
OG0004573	2	2	1	1	6
OG0004574	2	1	2	1	6
OG0004575	2	2	1	1	6
OG0004576	4	0	0	2	6
OG0004577	1	0	0	5	6
OG0004578	3	0	2	1	6
OG0004579	3	0	1	2	6
OG0004580	1	3	0	2	6
OG0004581	4	0	1	1	6
OG0004582	6	0	0	0	6
OG0004583	2	1	1	2	6
OG0004584	6	0	0	0	6
OG0004585	3	2	0	1	6
OG0004586	6	0	0	0	6
OG0004587	3	2	0	1	6
OG0004588	4	0	0	2	6
OG0004589	2	1	0	3	6
OG0004590	3	2	0	1	6
OG0004591	2	1	1	2	6
OG0004592	6	0	0	0	6
OG0004593	6	0	0	0	6
OG0004594	3	1	1	1	6
OG0004595	2	1	2	1	6
OG0004596	6	0	0	0	6
OG0004597	5	0	0	1	6
OG0004598	4	0	0	2	6
OG0004599	1	2	1	2	6
OG0004600	6	0	0	0	6
OG0004601	5	0	0	1	6
OG0004602	3	2	0	1	6
OG0004603	2	2	1	1	6
OG0004604	2	2	1	1	6
OG0004605	2	2	1	1	6
OG0004606	6	0	0	0	6
OG0004607	6	0	0	0	6
OG0004608	4	0	0	2	6
OG0004609	1	0	0	5	6
OG0004610	3	1	0	2	6
OG0004611	1	3	0	2	6
OG0004612	3	1	1	1	6
OG0004613	1	0	0	5	6
OG0004614	2	1	2	1	6
OG0004615	3	0	2	1	6
OG0004616	6	0	0	0	6
OG0004617	6	0	0	0	6
OG0004618	6	0	0	0	6
OG0004619	6	0	0	0	6
OG0004620	6	0	0	0	6
OG0004621	3	2	0	1	6
OG0004622	6	0	0	0	6
OG0004623	1	0	0	5	6
OG0004624	6	0	0	0	6
OG0004625	6	0	0	0	6
OG0004626	1	0	0	5	6
OG0004627	2	2	0	2	6
OG0004628	2	1	1	2	6
OG0004629	3	1	0	2	6
OG0004630	2	1	2	1	6
OG0004631	1	1	3	1	6
OG0004632	5	0	0	1	6
OG0004633	2	1	1	2	6
OG0004634	3	1	1	1	6
OG0004635	1	5	0	0	6
OG0004636	2	1	1	2	6
OG0004637	2	0	0	4	6
OG0004638	5	1	0	0	6
OG0004639	2	2	1	1	6
OG0004640	4	0	0	2	6
OG0004641	1	4	0	1	6
OG0004642	1	2	1	2	6
OG0004643	2	2	1	1	6
OG0004644	2	1	1	2	6
OG0004645	5	0	0	1	6
OG0004646	1	1	2	2	6
OG0004647	1	2	2	1	6
OG0004648	6	0	0	0	6
OG0004649	6	0	0	0	6
OG0004650	1	1	0	4	6
OG0004651	2	1	1	2	6
OG0004652	1	0	0	5	6
OG0004653	1	2	2	1	6
OG0004654	1	1	3	1	6
OG0004655	6	0	0	0	6
OG0004656	1	0	0	5	6
OG0004657	2	2	1	1	6
OG0004658	3	1	1	1	6
OG0004659	1	4	0	1	6
OG0004660	2	2	1	1	6
OG0004661	1	0	0	5	6
OG0004662	2	2	1	1	6
OG0004663	6	0	0	0	6
OG0004664	1	3	0	2	6
OG0004665	3	0	0	3	6
OG0004666	2	2	0	2	6
OG0004667	2	2	1	1	6
OG0004668	2	1	1	2	6
OG0004669	2	3	0	1	6
OG0004670	1	0	3	2	6
OG0004671	6	0	0	0	6
OG0004672	6	0	0	0	6
OG0004673	1	1	3	1	6
OG0004674	3	1	1	1	6
OG0004675	1	1	2	2	6
OG0004676	3	1	1	1	6
OG0004677	2	1	1	2	6
OG0004678	1	2	1	2	6
OG0004679	2	1	2	1	6
OG0004680	2	2	1	1	6
OG0004681	1	0	0	5	6
OG0004682	3	1	1	1	6
OG0004683	1	1	3	1	6
OG0004684	4	0	1	1	6
OG0004685	6	0	0	0	6
OG0004686	4	0	0	2	6
OG0004687	1	3	1	1	6
OG0004688	1	3	1	1	6
OG0004689	1	3	0	2	6
OG0004690	1	2	1	2	6
OG0004691	2	2	1	1	6
OG0004692	2	2	1	1	6
OG0004693	3	3	0	0	6
OG0004694	3	1	1	1	6
OG0004695	2	0	0	4	6
OG0004696	2	0	0	4	6
OG0004697	1	0	0	5	6
OG0004698	2	0	1	3	6
OG0004699	1	1	3	1	6
OG0004700	2	0	0	4	6
OG0004701	1	0	0	5	6
OG0004702	1	1	2	2	6
OG0004703	1	2	1	2	6
OG0004704	2	1	2	1	6
OG0004705	2	2	1	1	6
OG0004706	1	1	2	2	6
OG0004707	1	2	2	1	6
OG0004708	3	0	0	3	6
OG0004709	3	0	0	3	6
OG0004710	1	1	3	1	6
OG0004711	6	0	0	0	6
OG0004712	1	3	1	1	6
OG0004713	1	1	2	2	6
OG0004714	1	1	0	4	6
OG0004715	2	0	0	4	6
OG0004716	1	2	1	2	6
OG0004717	3	1	1	1	6
OG0004718	1	2	2	1	6
OG0004719	6	0	0	0	6
OG0004720	6	0	0	0	6
OG0004721	6	0	0	0	6
OG0004722	1	1	2	2	6
OG0004723	1	1	1	3	6
OG0004724	4	2	0	0	6
OG0004725	2	0	0	4	6
OG0004726	2	2	1	1	6
OG0004727	1	1	3	1	6
OG0004728	2	2	1	1	6
OG0004729	5	0	0	1	6
OG0004730	1	2	1	2	6
OG0004731	1	2	1	2	6
OG0004732	2	1	2	1	6
OG0004733	5	0	0	1	6
OG0004734	1	2	1	2	6
OG0004735	1	1	1	3	6
OG0004736	1	1	0	4	6
OG0004737	2	1	1	2	6
OG0004738	1	2	1	2	6
OG0004739	1	2	1	2	6
OG0004740	1	2	1	2	6
OG0004741	1	1	3	1	6
OG0004742	1	3	1	1	6
OG0004743	1	2	2	1	6
OG0004744	1	2	2	1	6
OG0004745	2	1	2	1	6
OG0004746	1	1	3	1	6
OG0004747	1	1	3	1	6
OG0004748	3	1	0	2	6
OG0004749	1	1	0	4	6
OG0004750	1	0	0	5	6
OG0004751	1	2	1	2	6
OG0004752	1	1	1	3	6
OG0004753	2	0	0	4	6
OG0004754	2	0	2	2	6
OG0004755	1	2	2	1	6
OG0004756	2	1	1	2	6
OG0004757	1	1	3	1	6
OG0004758	1	2	2	1	6
OG0004759	1	0	0	5	6
OG0004760	2	0	0	4	6
OG0004761	1	1	3	1	6
OG0004762	1	4	0	1	6
OG0004763	1	0	0	5	6
OG0004764	1	0	0	5	6
OG0004765	1	1	2	2	6
OG0004766	2	1	1	2	6
OG0004767	2	1	2	1	6
OG0004768	6	0	0	0	6
OG0004769	1	0	5	0	6
OG0004770	1	1	3	1	6
OG0004771	1	1	3	1	6
OG0004772	3	1	0	2	6
OG0004773	1	1	3	1	6
OG0004774	1	3	1	1	6
OG0004775	3	0	2	1	6
OG0004776	1	1	3	1	6
OG0004777	3	0	0	3	6
OG0004778	1	2	2	1	6
OG0004779	1	0	3	2	6
OG0004780	1	1	3	1	6
OG0004781	1	2	2	1	6
OG0004782	1	1	2	2	6
OG0004783	2	0	0	4	6
OG0004784	1	3	1	1	6
OG0004785	1	2	1	2	6
OG0004786	1	1	3	1	6
OG0004787	1	1	3	1	6
OG0004788	2	1	1	2	6
OG0004789	1	4	0	1	6
OG0004790	1	0	2	3	6
OG0004791	1	1	1	3	6
OG0004792	1	1	3	1	6
OG0004793	1	1	2	2	6
OG0004794	1	1	0	4	6
OG0004795	1	2	2	1	6
OG0004796	1	2	0	3	6
OG0004797	1	2	1	2	6
OG0004798	1	1	3	1	6
OG0004799	2	0	0	4	6
OG0004800	2	1	1	2	6
OG0004801	1	1	1	3	6
OG0004802	1	0	0	5	6
OG0004803	1	2	2	1	6
OG0004804	1	1	3	1	6
OG0004805	1	3	1	1	6
OG0004806	1	3	1	1	6
OG0004807	1	1	3	1	6
OG0004808	2	2	0	2	6
OG0004809	1	1	1	3	6
OG0004810	1	3	1	1	6
OG0004811	1	2	1	2	6
OG0004812	6	0	0	0	6
OG0004813	2	2	1	1	6
OG0004814	3	0	0	3	6
OG0004815	1	1	1	3	6
OG0004816	1	0	0	5	6
OG0004817	1	2	1	2	6
OG0004818	1	1	1	3	6
OG0004819	1	3	1	1	6
OG0004820	1	1	2	2	6
OG0004821	1	0	0	5	6
OG0004822	1	0	1	4	6
OG0004823	1	2	2	1	6
OG0004824	1	2	1	2	6
OG0004825	1	3	0	2	6
OG0004826	1	1	0	4	6
OG0004827	1	1	2	2	6
OG0004828	3	1	1	1	6
OG0004829	3	0	0	3	6
OG0004830	2	3	0	1	6
OG0004831	2	2	0	2	6
OG0004832	1	2	1	2	6
OG0004833	1	1	3	1	6
OG0004834	1	2	1	2	6
OG0004835	2	0	0	4	6
OG0004836	2	1	1	2	6
OG0004837	4	0	0	2	6
OG0004838	1	2	2	1	6
OG0004839	1	0	0	5	6
OG0004840	1	2	2	1	6
OG0004841	3	0	0	3	6
OG0004842	1	1	2	2	6
OG0004843	1	2	1	2	6
OG0004844	1	1	2	2	6
OG0004845	1	1	2	2	6
OG0004846	1	2	2	1	6
OG0004847	1	1	1	3	6
OG0004848	1	2	2	1	6
OG0004849	1	2	2	1	6
OG0004850	1	1	2	2	6
OG0004851	1	2	1	2	6
OG0004852	1	2	1	2	6
OG0004853	1	2	2	1	6
OG0004854	1	2	1	2	6
OG0004855	2	1	2	1	6
OG0004856	1	1	2	2	6
OG0004857	1	2	1	2	6
OG0004858	2	0	0	4	6
OG0004859	1	1	3	1	6
OG0004860	1	1	3	1	6
OG0004861	1	2	1	2	6
OG0004862	2	0	0	4	6
OG0004863	1	1	2	2	6
OG0004864	1	1	0	4	6
OG0004865	1	0	0	5	6
OG0004866	1	1	2	2	6
OG0004867	1	1	2	2	6
OG0004868	1	2	1	2	6
OG0004869	1	3	1	1	6
OG0004870	2	1	1	2	6
OG0004871	1	1	2	2	6
OG0004872	1	2	2	1	6
OG0004873	1	1	3	1	6
OG0004874	1	4	0	1	6
OG0004875	1	1	2	2	6
OG0004876	1	2	2	1	6
OG0004877	1	2	1	2	6
OG0004878	1	1	2	2	6
OG0004879	1	1	3	1	6
OG0004880	2	3	0	1	6
OG0004881	1	0	4	1	6
OG0004882	1	3	1	1	6
OG0004883	2	0	3	1	6
OG0004884	1	2	2	1	6
OG0004885	1	1	3	1	6
OG0004886	1	2	1	2	6
OG0004887	1	2	2	1	6
OG0004888	1	2	2	1	6
OG0004889	1	0	0	5	6
OG0004890	2	1	2	1	6
OG0004891	1	1	3	1	6
OG0004892	1	3	1	1	6
OG0004893	1	1	1	3	6
OG0004894	1	5	0	0	6
OG0004895	1	2	2	1	6
OG0004896	2	2	1	1	6
OG0004897	3	1	1	1	6
OG0004898	1	1	1	3	6
OG0004899	1	0	0	5	6
OG0004900	2	2	1	1	6
OG0004901	1	1	1	3	6
OG0004902	2	2	1	1	6
OG0004903	2	4	0	0	6
OG0004904	4	0	0	2	6
OG0004905	1	2	2	1	6
OG0004906	1	1	2	2	6
OG0004907	1	2	2	1	6
OG0004908	2	2	1	1	6
OG0004909	1	0	0	5	6
OG0004910	1	1	3	1	6
OG0004911	1	1	1	3	6
OG0004912	1	1	3	1	6
OG0004913	1	1	2	2	6
OG0004914	1	1	3	1	6
OG0004915	1	1	3	1	6
OG0004916	1	2	1	2	6
OG0004917	1	1	1	3	6
OG0004918	1	3	1	1	6
OG0004919	2	2	1	1	6
OG0004920	1	2	2	1	6
OG0004921	1	2	2	1	6
OG0004922	1	2	1	2	6
OG0004923	1	3	0	2	6
OG0004924	1	1	3	1	6
OG0004925	2	1	2	1	6
OG0004926	1	3	0	2	6
OG0004927	1	2	1	2	6
OG0004928	2	2	1	1	6
OG0004929	1	2	2	1	6
OG0004930	1	1	2	2	6
OG0004931	1	1	3	1	6
OG0004932	1	1	2	2	6
OG0004933	1	3	1	1	6
OG0004934	1	1	2	2	6
OG0004935	1	1	1	3	6
OG0004936	1	2	2	1	6
OG0004937	1	3	1	1	6
OG0004938	1	2	2	1	6
OG0004939	1	3	1	1	6
OG0004940	3	1	2	0	6
OG0004941	1	0	2	3	6
OG0004942	1	4	0	1	6
OG0004943	1	2	1	2	6
OG0004944	1	2	2	1	6
OG0004945	1	1	2	2	6
OG0004946	1	3	1	1	6
OG0004947	1	1	1	3	6
OG0004948	2	1	2	1	6
OG0004949	2	0	0	4	6
OG0004950	1	4	0	1	6
OG0004951	1	3	1	1	6
OG0004952	1	2	0	3	6
OG0004953	1	2	1	2	6
OG0004954	2	0	2	2	6
OG0004955	1	1	1	3	6
OG0004956	3	1	1	1	6
OG0004957	2	2	0	2	6
OG0004958	1	2	2	1	6
OG0004959	2	0	0	4	6
OG0004960	1	0	1	4	6
OG0004961	1	2	1	2	6
OG0004962	1	1	0	4	6
OG0004963	4	0	0	2	6
OG0004964	1	2	1	2	6
OG0004965	1	1	2	2	6
OG0004966	1	3	1	1	6
OG0004967	1	2	2	1	6
OG0004968	1	3	1	1	6
OG0004969	1	1	3	1	6
OG0004970	1	1	1	3	6
OG0004971	2	2	1	1	6
OG0004972	4	0	0	2	6
OG0004973	1	0	1	4	6
OG0004974	1	1	1	3	6
OG0004975	2	1	2	1	6
OG0004976	1	2	2	1	6
OG0004977	2	1	1	2	6
OG0004978	1	2	1	2	6
OG0004979	1	1	3	1	6
OG0004980	1	1	1	3	6
OG0004981	1	0	0	5	6
OG0004982	1	1	2	2	6
OG0004983	1	3	1	1	6
OG0004984	2	0	0	4	6
OG0004985	1	1	1	3	6
OG0004986	1	1	2	2	6
OG0004987	1	4	0	1	6
OG0004988	1	1	3	1	6
OG0004989	1	2	0	3	6
OG0004990	1	0	0	5	6
OG0004991	1	1	3	1	6
OG0004992	2	0	0	4	6
OG0004993	2	1	0	3	6
OG0004994	2	3	0	1	6
OG0004995	1	4	0	1	6
OG0004996	1	1	2	2	6
OG0004997	1	1	3	1	6
OG0004998	1	1	3	1	6
OG0004999	2	2	1	1	6
OG0005000	1	1	3	1	6
OG0005001	1	3	1	1	6
OG0005002	1	0	1	4	6
OG0005003	1	2	1	2	6
OG0005004	1	2	2	1	6
OG0005005	1	1	3	1	6
OG0005006	2	1	1	2	6
OG0005007	1	2	2	1	6
OG0005008	1	3	1	1	6
OG0005009	1	1	3	1	6
OG0005010	1	4	0	1	6
OG0005011	1	0	0	5	6
OG0005012	1	2	2	1	6
OG0005013	1	2	1	2	6
OG0005014	3	1	0	2	6
OG0005015	3	0	2	1	6
OG0005016	1	1	2	2	6
OG0005017	1	3	1	1	6
OG0005018	1	2	2	1	6
OG0005019	2	1	2	1	6
OG0005020	1	3	1	1	6
OG0005021	1	1	2	2	6
OG0005022	2	2	1	1	6
OG0005023	1	2	1	2	6
OG0005024	1	0	0	5	6
OG0005025	1	0	4	1	6
OG0005026	1	3	1	1	6
OG0005027	2	2	1	1	6
OG0005028	1	2	2	1	6
OG0005029	2	0	0	4	6
OG0005030	1	1	3	1	6
OG0005031	2	2	0	2	6
OG0005032	1	0	0	5	6
OG0005033	1	0	3	2	6
OG0005034	1	2	1	2	6
OG0005035	1	1	3	1	6
OG0005036	1	2	2	1	6
OG0005037	1	2	0	3	6
OG0005038	2	1	1	2	6
OG0005039	1	3	1	1	6
OG0005040	1	3	1	1	6
OG0005041	2	1	1	2	6
OG0005042	1	1	3	1	6
OG0005043	1	2	1	2	6
OG0005044	1	0	0	5	6
OG0005045	1	0	3	2	6
OG0005046	2	1	2	1	6
OG0005047	1	3	1	1	6
OG0005048	1	1	1	3	6
OG0005049	1	2	1	2	6
OG0005050	1	3	1	1	6
OG0005051	1	1	2	2	6
OG0005052	1	1	3	1	6
OG0005053	1	2	2	1	6
OG0005054	1	1	1	3	6
OG0005055	1	1	3	1	6
OG0005056	1	2	1	2	6
OG0005057	2	1	1	2	6
OG0005058	1	4	0	1	6
OG0005059	1	1	1	3	6
OG0005060	3	2	0	1	6
OG0005061	1	3	1	1	6
OG0005062	1	1	3	1	6
OG0005063	1	5	0	0	6
OG0005064	1	2	2	1	6
OG0005065	1	2	1	2	6
OG0005066	1	1	3	1	6
OG0005067	1	3	1	1	6
OG0005068	1	2	1	2	6
OG0005069	1	3	1	1	6
OG0005070	1	3	0	2	6
OG0005071	1	2	2	1	6
OG0005072	1	4	0	1	6
OG0005073	1	0	0	5	6
OG0005074	1	3	1	1	6
OG0005075	1	1	3	1	6
OG0005076	3	1	0	2	6
OG0005077	1	1	1	3	6
OG0005078	1	2	1	2	6
OG0005079	1	1	3	1	6
OG0005080	1	1	1	3	6
OG0005081	1	1	2	2	6
OG0005082	1	2	1	2	6
OG0005083	3	0	0	3	6
OG0005084	1	1	1	3	6
OG0005085	1	0	3	2	6
OG0005086	1	3	1	1	6
OG0005087	2	1	1	2	6
OG0005088	1	2	2	1	6
OG0005089	1	5	0	0	6
OG0005090	1	2	1	2	6
OG0005091	1	1	3	1	6
OG0005092	1	1	3	1	6
OG0005093	1	0	0	5	6
OG0005094	2	1	1	2	6
OG0005095	1	3	1	1	6
OG0005096	1	3	1	1	6
OG0005097	1	0	3	2	6
OG0005098	2	1	2	1	6
OG0005099	1	2	2	1	6
OG0005100	1	2	2	1	6
OG0005101	1	2	2	1	6
OG0005102	2	3	0	1	6
OG0005103	1	3	1	1	6
OG0005104	4	0	0	2	6
OG0005105	1	1	2	2	6
OG0005106	1	1	3	1	6
OG0005107	1	4	0	1	6
OG0005108	1	2	2	1	6
OG0005109	1	3	1	1	6
OG0005110	1	1	3	1	6
OG0005111	1	0	4	1	6
OG0005112	1	1	2	2	6
OG0005113	2	2	1	1	6
OG0005114	1	1	3	1	6
OG0005115	1	3	1	1	6
OG0005116	2	0	1	3	6
OG0005117	1	3	1	1	6
OG0005118	1	1	3	1	6
OG0005119	1	2	2	1	6
OG0005120	1	1	3	1	6
OG0005121	1	2	2	1	6
OG0005122	1	0	4	1	6
OG0005123	1	1	3	1	6
OG0005124	1	2	2	1	6
OG0005125	1	3	1	1	6
OG0005126	2	1	1	2	6
OG0005127	1	1	3	1	6
OG0005128	2	0	2	2	6
OG0005129	1	1	3	1	6
OG0005130	1	0	0	5	6
OG0005131	2	2	1	1	6
OG0005132	1	2	2	1	6
OG0005133	1	2	2	1	6
OG0005134	1	3	1	1	6
OG0005135	1	2	1	2	6
OG0005136	1	1	3	1	6
OG0005137	1	2	1	2	6
OG0005138	1	2	2	1	6
OG0005139	1	3	1	1	6
OG0005140	1	1	2	2	6
OG0005141	1	2	1	2	6
OG0005142	3	1	1	1	6
OG0005143	1	1	3	1	6
OG0005144	1	2	2	1	6
OG0005145	1	2	0	3	6
OG0005146	1	2	1	2	6
OG0005147	1	2	2	1	6
OG0005148	1	1	2	2	6
OG0005149	2	2	1	1	6
OG0005150	1	2	2	1	6
OG0005151	2	2	0	2	6
OG0005152	1	1	3	1	6
OG0005153	1	2	2	1	6
OG0005154	1	1	3	1	6
OG0005155	1	3	1	1	6
OG0005156	1	3	1	1	6
OG0005157	1	2	1	2	6
OG0005158	1	1	1	3	6
OG0005159	1	0	0	5	6
OG0005160	2	4	0	0	6
OG0005161	1	2	2	1	6
OG0005162	1	2	2	1	6
OG0005163	1	2	2	1	6
OG0005164	1	2	2	1	6
OG0005165	1	2	0	3	6
OG0005166	1	2	1	2	6
OG0005167	2	1	1	2	6
OG0005168	1	0	0	5	6
OG0005169	1	1	1	3	6
OG0005170	1	2	1	2	6
OG0005171	1	0	5	0	6
OG0005172	1	1	3	1	6
OG0005173	1	1	3	1	6
OG0005174	2	1	1	2	6
OG0005175	1	0	3	2	6
OG0005176	1	2	2	1	6
OG0005177	2	2	1	1	6
OG0005178	1	1	3	1	6
OG0005179	1	3	1	1	6
OG0005180	1	1	3	1	6
OG0005181	1	4	0	1	6
OG0005182	1	1	3	1	6
OG0005183	1	0	0	5	6
OG0005184	1	1	1	3	6
OG0005185	1	1	2	2	6
OG0005186	1	1	2	2	6
OG0005187	1	2	2	1	6
OG0005188	1	1	2	2	6
OG0005189	1	2	2	1	6
OG0005190	1	1	2	2	6
OG0005191	1	2	1	2	6
OG0005192	1	0	4	1	6
OG0005193	1	2	1	2	6
OG0005194	1	2	1	2	6
OG0005195	1	2	2	1	6
OG0005196	1	3	1	1	6
OG0005197	1	0	1	4	6
OG0005198	1	3	1	1	6
OG0005199	1	2	3	0	6
OG0005200	1	2	1	2	6
OG0005201	1	2	2	1	6
OG0005202	1	2	2	1	6
OG0005203	2	0	1	3	6
OG0005204	1	3	1	1	6
OG0005205	1	3	1	1	6
OG0005206	1	2	2	1	6
OG0005207	1	3	0	2	6
OG0005208	1	2	1	2	6
OG0005209	1	3	1	1	6
OG0005210	1	1	3	1	6
OG0005211	1	1	3	1	6
OG0005212	1	3	1	1	6
OG0005213	1	1	3	1	6
OG0005214	1	1	0	4	6
OG0005215	1	3	0	2	6
OG0005216	1	3	1	1	6
OG0005217	1	2	2	1	6
OG0005218	1	3	1	1	6
OG0005219	1	3	1	1	6
OG0005220	1	0	0	5	6
OG0005221	1	1	3	1	6
OG0005222	2	1	1	2	6
OG0005223	2	2	1	1	6
OG0005224	1	1	3	1	6
OG0005225	1	2	2	1	6
OG0005226	1	3	1	1	6
OG0005227	1	2	2	1	6
OG0005228	1	1	1	3	6
OG0005229	1	0	4	1	6
OG0005230	1	2	2	1	6
OG0005231	1	2	2	1	6
OG0005232	1	1	3	1	6
OG0005233	1	1	3	1	6
OG0005234	2	1	2	1	6
OG0005235	1	2	2	1	6
OG0005236	1	1	3	1	6
OG0005237	1	1	1	3	6
OG0005238	1	2	2	1	6
OG0005239	2	1	2	1	6
OG0005240	1	2	2	1	6
OG0005241	1	3	1	1	6
OG0005242	1	1	3	1	6
OG0005243	1	2	2	1	6
OG0005244	1	1	1	3	6
OG0005245	2	2	1	1	6
OG0005246	2	2	1	1	6
OG0005247	1	2	2	1	6
OG0005248	2	0	3	1	6
OG0005249	1	2	2	1	6
OG0005250	1	1	2	2	6
OG0005251	1	1	2	2	6
OG0005252	1	1	1	3	6
OG0005253	1	2	2	1	6
OG0005254	1	1	2	2	6
OG0005255	1	1	1	3	6
OG0005256	1	2	1	2	6
OG0005257	1	3	1	1	6
OG0005258	2	0	1	3	6
OG0005259	1	1	1	3	6
OG0005260	1	0	3	2	6
OG0005261	1	3	1	1	6
OG0005262	1	0	3	2	6
OG0005263	1	3	1	1	6
OG0005264	1	1	2	2	6
OG0005265	1	1	1	3	6
OG0005266	1	3	1	1	6
OG0005267	1	1	1	3	6
OG0005268	1	3	1	1	6
OG0005269	1	2	0	3	6
OG0005270	1	1	1	3	6
OG0005271	1	2	2	1	6
OG0005272	1	1	3	1	6
OG0005273	1	3	1	1	6
OG0005274	1	3	1	1	6
OG0005275	1	2	2	1	6
OG0005276	1	3	1	1	6
OG0005277	1	2	1	2	6
OG0005278	1	1	1	3	6
OG0005279	1	2	2	1	6
OG0005280	1	1	3	1	6
OG0005281	1	1	3	1	6
OG0005282	1	2	1	2	6
OG0005283	1	2	2	1	6
OG0005284	1	2	1	2	6
OG0005285	1	3	1	1	6
OG0005286	2	2	1	1	6
OG0005287	1	3	1	1	6
OG0005288	1	0	0	5	6
OG0005289	1	3	1	1	6
OG0005290	1	1	1	3	6
OG0005291	1	1	3	1	6
OG0005292	1	1	2	2	6
OG0005293	2	1	2	1	6
OG0005294	1	0	1	4	6
OG0005295	1	3	1	1	6
OG0005296	1	1	3	1	6
OG0005297	1	1	1	3	6
OG0005298	1	2	1	2	6
OG0005299	1	2	2	1	6
OG0005300	1	2	2	1	6
OG0005301	1	0	4	1	6
OG0005302	2	1	1	2	6
OG0005303	1	1	1	3	6
OG0005304	1	2	2	1	6
OG0005305	1	3	1	1	6
OG0005306	1	1	2	2	6
OG0005307	1	1	1	3	6
OG0005308	1	1	1	3	6
OG0005309	1	1	2	2	6
OG0005310	1	2	2	1	6
OG0005311	1	4	0	1	6
OG0005312	1	3	1	1	6
OG0005313	1	3	1	1	6
OG0005314	1	1	1	3	6
OG0005315	1	2	1	2	6
OG0005316	1	1	2	2	6
OG0005317	1	1	3	1	6
OG0005318	1	1	3	1	6
OG0005319	1	2	2	1	6
OG0005320	1	3	1	1	6
OG0005321	1	2	0	3	6
OG0005322	2	2	1	1	6
OG0005323	1	2	2	1	6
OG0005324	1	2	1	2	6
OG0005325	1	3	1	1	6
OG0005326	1	0	0	5	6
OG0005327	1	2	1	2	6
OG0005328	1	1	3	1	6
OG0005329	1	2	1	2	6
OG0005330	1	1	3	1	6
OG0005331	1	1	1	3	6
OG0005332	2	2	1	1	6
OG0005333	1	2	2	1	6
OG0005334	1	1	1	3	6
OG0005335	1	3	1	1	6
OG0005336	1	2	2	1	6
OG0005337	1	2	2	1	6
OG0005338	2	1	1	2	6
OG0005339	1	1	3	1	6
OG0005340	1	0	1	4	6
OG0005341	1	0	4	1	6
OG0005342	1	1	2	2	6
OG0005343	1	3	1	1	6
OG0005344	1	3	1	1	6
OG0005345	1	0	0	5	6
OG0005346	1	0	0	5	6
OG0005347	1	2	1	2	6
OG0005348	1	2	2	1	6
OG0005349	1	0	0	5	6
OG0005350	1	2	1	2	6
OG0005351	1	2	2	1	6
OG0005352	1	1	3	1	6
OG0005353	1	1	1	3	6
OG0005354	1	1	3	1	6
OG0005355	1	1	3	1	6
OG0005356	1	3	1	1	6
OG0005357	1	0	0	5	6
OG0005358	1	2	1	2	6
OG0005359	1	2	2	1	6
OG0005360	1	2	1	2	6
OG0005361	1	1	3	1	6
OG0005362	1	1	1	3	6
OG0005363	1	3	1	1	6
OG0005364	2	0	1	3	6
OG0005365	1	0	2	3	6
OG0005366	1	2	1	2	6
OG0005367	1	1	3	1	6
OG0005368	1	1	3	1	6
OG0005369	1	4	0	1	6
OG0005370	1	1	3	1	6
OG0005371	1	2	2	1	6
OG0005372	1	1	0	4	6
OG0005373	1	3	1	1	6
OG0005374	1	2	2	1	6
OG0005375	1	2	2	1	6
OG0005376	1	1	2	2	6
OG0005377	1	2	2	1	6
OG0005378	1	1	2	2	6
OG0005379	1	2	2	1	6
OG0005380	1	3	0	2	6
OG0005381	2	0	0	4	6
OG0005382	1	3	1	1	6
OG0005383	1	1	3	1	6
OG0005384	1	1	3	1	6
OG0005385	2	1	2	1	6
OG0005386	1	2	1	2	6
OG0005387	1	2	1	2	6
OG0005388	1	1	1	3	6
OG0005389	1	1	3	1	6
OG0005390	1	1	3	1	6
OG0005391	1	1	3	1	6
OG0005392	1	1	0	4	6
OG0005393	1	3	1	1	6
OG0005394	1	3	0	2	6
OG0005395	1	2	1	2	6
OG0005396	1	2	1	2	6
OG0005397	2	2	0	2	6
OG0005398	1	1	1	3	6
OG0005399	1	1	2	2	6
OG0005400	1	1	1	3	6
OG0005401	1	1	2	2	6
OG0005402	1	0	0	5	6
OG0005403	1	2	2	1	6
OG0005404	1	1	3	1	6
OG0005405	1	1	2	2	6
OG0005406	1	2	2	1	6
OG0005407	1	1	3	1	6
OG0005408	0	6	0	0	6
OG0005409	0	6	0	0	6
OG0005410	0	6	0	0	6
OG0005411	0	6	0	0	6
OG0005412	0	6	0	0	6
OG0005413	0	6	0	0	6
OG0005414	0	6	0	0	6
OG0005415	0	6	0	0	6
OG0005416	0	6	0	0	6
OG0005417	0	6	0	0	6
OG0005418	0	6	0	0	6
OG0005419	0	6	0	0	6
OG0005420	0	6	0	0	6
OG0005421	0	5	1	0	6
OG0005422	0	6	0	0	6
OG0005423	0	6	0	0	6
OG0005424	0	6	0	0	6
OG0005425	0	6	0	0	6
OG0005426	0	6	0	0	6
OG0005427	0	6	0	0	6
OG0005428	0	6	0	0	6
OG0005429	0	6	0	0	6
OG0005430	0	5	1	0	6
OG0005431	0	6	0	0	6
OG0005432	0	5	1	0	6
OG0005433	0	6	0	0	6
OG0005434	0	6	0	0	6
OG0005435	0	6	0	0	6
OG0005436	0	6	0	0	6
OG0005437	0	6	0	0	6
OG0005438	0	6	0	0	6
OG0005439	0	6	0	0	6
OG0005440	0	6	0	0	6
OG0005441	0	6	0	0	6
OG0005442	0	6	0	0	6
OG0005443	0	6	0	0	6
OG0005444	0	6	0	0	6
OG0005445	0	6	0	0	6
OG0005446	0	6	0	0	6
OG0005447	0	6	0	0	6
OG0005448	0	6	0	0	6
OG0005449	0	6	0	0	6
OG0005450	0	6	0	0	6
OG0005451	0	6	0	0	6
OG0005452	0	6	0	0	6
OG0005453	0	6	0	0	6
OG0005454	0	6	0	0	6
OG0005455	0	6	0	0	6
OG0005456	0	6	0	0	6
OG0005457	0	6	0	0	6
OG0005458	0	6	0	0	6
OG0005459	0	6	0	0	6
OG0005460	0	6	0	0	6
OG0005461	0	6	0	0	6
OG0005462	0	6	0	0	6
OG0005463	0	6	0	0	6
OG0005464	0	6	0	0	6
OG0005465	0	6	0	0	6
OG0005466	0	6	0	0	6
OG0005467	0	6	0	0	6
OG0005468	0	6	0	0	6
OG0005469	0	6	0	0	6
OG0005470	0	6	0	0	6
OG0005471	0	6	0	0	6
OG0005472	0	6	0	0	6
OG0005473	0	6	0	0	6
OG0005474	0	6	0	0	6
OG0005475	0	4	0	2	6
OG0005476	0	6	0	0	6
OG0005477	0	6	0	0	6
OG0005478	0	6	0	0	6
OG0005479	0	6	0	0	6
OG0005480	0	6	0	0	6
OG0005481	0	6	0	0	6
OG0005482	0	6	0	0	6
OG0005483	0	6	0	0	6
OG0005484	0	6	0	0	6
OG0005485	0	6	0	0	6
OG0005486	0	1	0	5	6
OG0005487	0	6	0	0	6
OG0005488	0	6	0	0	6
OG0005489	0	6	0	0	6
OG0005490	0	6	0	0	6
OG0005491	0	6	0	0	6
OG0005492	0	6	0	0	6
OG0005493	0	6	0	0	6
OG0005494	0	6	0	0	6
OG0005495	0	6	0	0	6
OG0005496	0	6	0	0	6
OG0005497	0	6	0	0	6
OG0005498	0	6	0	0	6
OG0005499	0	6	0	0	6
OG0005500	0	6	0	0	6
OG0005501	0	6	0	0	6
OG0005502	0	6	0	0	6
OG0005503	0	6	0	0	6
OG0005504	0	6	0	0	6
OG0005505	0	6	0	0	6
OG0005506	0	6	0	0	6
OG0005507	0	6	0	0	6
OG0005508	0	6	0	0	6
OG0005509	0	1	3	2	6
OG0005510	0	2	4	0	6
OG0005511	0	6	0	0	6
OG0005512	0	2	0	4	6
OG0005513	0	1	5	0	6
OG0005514	0	6	0	0	6
OG0005515	0	6	0	0	6
OG0005516	0	6	0	0	6
OG0005517	0	2	3	1	6
OG0005518	0	3	3	0	6
OG0005519	0	6	0	0	6
OG0005520	0	6	0	0	6
OG0005521	0	6	0	0	6
OG0005522	0	6	0	0	6
OG0005523	0	2	2	2	6
OG0005524	0	1	5	0	6
OG0005525	0	3	1	2	6
OG0005526	0	6	0	0	6
OG0005527	0	6	0	0	6
OG0005528	0	6	0	0	6
OG0005529	0	6	0	0	6
OG0005530	0	6	0	0	6
OG0005531	0	6	0	0	6
OG0005532	0	6	0	0	6
OG0005533	0	1	0	5	6
OG0005534	0	6	0	0	6
OG0005535	0	6	0	0	6
OG0005536	0	6	0	0	6
OG0005537	0	6	0	0	6
OG0005538	0	1	0	5	6
OG0005539	0	0	6	0	6
OG0005540	0	0	6	0	6
OG0005541	0	0	6	0	6
OG0005542	0	0	6	0	6
OG0005543	0	0	6	0	6
OG0005544	0	0	6	0	6
OG0005545	0	0	6	0	6
OG0005546	0	0	6	0	6
OG0005547	0	0	6	0	6
OG0005548	0	0	6	0	6
OG0005549	0	0	6	0	6
OG0005550	0	0	6	0	6
OG0005551	0	0	6	0	6
OG0005552	0	0	6	0	6
OG0005553	0	0	6	0	6
OG0005554	0	0	6	0	6
OG0005555	0	0	6	0	6
OG0005556	0	0	6	0	6
OG0005557	0	0	6	0	6
OG0005558	0	0	6	0	6
OG0005559	0	0	6	0	6
OG0005560	0	0	6	0	6
OG0005561	0	0	6	0	6
OG0005562	0	0	6	0	6
OG0005563	0	0	6	0	6
OG0005564	0	0	6	0	6
OG0005565	0	0	6	0	6
OG0005566	0	0	6	0	6
OG0005567	0	0	6	0	6
OG0005568	0	0	6	0	6
OG0005569	0	0	6	0	6
OG0005570	0	0	6	0	6
OG0005571	0	0	6	0	6
OG0005572	0	0	6	0	6
OG0005573	0	0	6	0	6
OG0005574	0	0	6	0	6
OG0005575	0	0	6	0	6
OG0005576	0	0	6	0	6
OG0005577	0	0	6	0	6
OG0005578	0	0	6	0	6
OG0005579	0	0	6	0	6
OG0005580	0	0	6	0	6
OG0005581	0	0	6	0	6
OG0005582	0	0	6	0	6
OG0005583	0	0	6	0	6
OG0005584	0	0	6	0	6
OG0005585	0	0	6	0	6
OG0005586	0	0	6	0	6
OG0005587	0	0	6	0	6
OG0005588	0	0	6	0	6
OG0005589	0	0	6	0	6
OG0005590	0	0	6	0	6
OG0005591	0	0	6	0	6
OG0005592	0	0	6	0	6
OG0005593	0	0	6	0	6
OG0005594	0	0	6	0	6
OG0005595	0	0	6	0	6
OG0005596	0	0	6	0	6
OG0005597	0	0	6	0	6
OG0005598	0	0	6	0	6
OG0005599	0	0	6	0	6
OG0005600	0	0	6	0	6
OG0005601	0	0	0	6	6
OG0005602	0	0	0	6	6
OG0005603	0	0	0	6	6
OG0005604	0	0	0	6	6
OG0005605	0	0	0	6	6
OG0005606	0	0	0	6	6
OG0005607	0	0	0	6	6
OG0005608	0	0	0	6	6
OG0005609	0	0	0	6	6
OG0005610	0	0	0	6	6
OG0005611	0	0	0	6	6
OG0005612	0	0	0	6	6
OG0005613	0	0	0	6	6
OG0005614	0	0	0	6	6
OG0005615	0	0	0	6	6
OG0005616	0	0	0	6	6
OG0005617	0	0	0	6	6
OG0005618	0	0	0	6	6
OG0005619	0	0	0	6	6
OG0005620	0	0	0	6	6
OG0005621	0	0	0	6	6
OG0005622	0	0	0	6	6
OG0005623	0	0	0	6	6
OG0005624	0	0	0	6	6
OG0005625	0	0	0	6	6
OG0005626	0	0	0	6	6
OG0005627	0	0	0	6	6
OG0005628	0	0	0	6	6
OG0005629	0	0	0	6	6
OG0005630	0	0	0	6	6
OG0005631	0	0	0	6	6
OG0005632	0	0	0	6	6
OG0005633	0	0	0	6	6
OG0005634	0	0	0	6	6
OG0005635	0	0	0	6	6
OG0005636	0	0	0	6	6
OG0005637	0	0	0	6	6
OG0005638	0	0	0	6	6
OG0005639	0	0	0	6	6
OG0005640	0	0	0	6	6
OG0005641	0	0	0	6	6
OG0005642	0	0	0	6	6
OG0005643	0	0	0	6	6
OG0005644	0	0	0	6	6
OG0005645	0	0	0	6	6
OG0005646	0	0	0	6	6
OG0005647	0	0	0	6	6
OG0005648	0	0	0	6	6
OG0005649	0	0	0	6	6
OG0005650	0	0	0	6	6
OG0005651	0	0	0	6	6
OG0005652	0	0	0	6	6
OG0005653	0	0	0	6	6
OG0005654	0	0	0	6	6
OG0005655	0	0	0	6	6
OG0005656	0	0	0	6	6
OG0005657	0	0	0	6	6
OG0005658	0	0	0	6	6
OG0005659	0	0	0	6	6
OG0005660	0	0	0	6	6
OG0005661	0	0	0	6	6
OG0005662	0	0	0	6	6
OG0005663	0	0	0	6	6
OG0005664	0	0	0	6	6
OG0005665	0	0	0	6	6
OG0005666	0	0	0	6	6
OG0005667	0	0	0	6	6
OG0005668	0	0	0	6	6
OG0005669	0	0	0	6	6
OG0005670	0	0	0	6	6
OG0005671	0	0	0	6	6
OG0005672	0	0	0	6	6
OG0005673	0	0	0	6	6
OG0005674	0	0	0	6	6
OG0005675	0	0	0	6	6
OG0005676	0	0	0	6	6
OG0005677	0	0	0	6	6
OG0005678	0	0	0	6	6
OG0005679	0	0	0	6	6
OG0005680	0	0	0	6	6
OG0005681	0	0	0	6	6
OG0005682	0	0	0	6	6
OG0005683	0	0	0	6	6
OG0005684	0	0	0	6	6
OG0005685	0	0	0	6	6
OG0005686	0	0	0	6	6
OG0005687	0	0	0	6	6
OG0005688	0	0	0	6	6
OG0005689	0	0	0	6	6
OG0005690	0	0	0	6	6
OG0005691	0	0	0	6	6
OG0005692	0	0	0	6	6
OG0005693	0	0	0	6	6
OG0005694	0	0	0	6	6
OG0005695	0	0	0	6	6
OG0005696	0	0	0	6	6
OG0005697	0	0	0	6	6
OG0005698	0	0	0	6	6
OG0005699	0	0	0	6	6
OG0005700	0	0	0	6	6
OG0005701	0	0	0	6	6
OG0005702	0	0	0	6	6
OG0005703	0	0	0	6	6
OG0005704	0	0	0	6	6
OG0005705	0	0	0	6	6
OG0005706	0	0	0	6	6
OG0005707	0	0	0	6	6
OG0005708	0	0	0	6	6
OG0005709	0	0	0	6	6
OG0005710	0	0	0	6	6
OG0005711	0	0	0	6	6
OG0005712	0	0	0	6	6
OG0005713	0	0	0	6	6
OG0005714	0	0	0	6	6
OG0005715	0	0	0	6	6
OG0005716	0	0	0	6	6
OG0005717	0	0	0	6	6
OG0005718	0	0	0	6	6
OG0005719	0	0	0	6	6
OG0005720	0	0	0	6	6
OG0005721	0	0	0	6	6
OG0005722	0	0	0	6	6
OG0005723	3	0	0	2	5
OG0005724	5	0	0	0	5
OG0005725	3	0	0	2	5
OG0005726	3	2	0	0	5
OG0005727	2	0	0	3	5
OG0005728	2	1	1	1	5
OG0005729	5	0	0	0	5
OG0005730	5	0	0	0	5
OG0005731	2	0	0	3	5
OG0005732	3	0	0	2	5
OG0005733	5	0	0	0	5
OG0005734	2	1	1	1	5
OG0005735	5	0	0	0	5
OG0005736	5	0	0	0	5
OG0005737	2	1	1	1	5
OG0005738	2	1	1	1	5
OG0005739	5	0	0	0	5
OG0005740	2	1	1	1	5
OG0005741	1	2	0	2	5
OG0005742	5	0	0	0	5
OG0005743	2	1	1	1	5
OG0005744	2	1	1	1	5
OG0005745	5	0	0	0	5
OG0005746	5	0	0	0	5
OG0005747	3	1	0	1	5
OG0005748	4	0	0	1	5
OG0005749	2	1	1	1	5
OG0005750	2	0	0	3	5
OG0005751	2	1	1	1	5
OG0005752	2	1	1	1	5
OG0005753	3	1	0	1	5
OG0005754	5	0	0	0	5
OG0005755	5	0	0	0	5
OG0005756	5	0	0	0	5
OG0005757	2	1	1	1	5
OG0005758	5	0	0	0	5
OG0005759	5	0	0	0	5
OG0005760	4	0	0	1	5
OG0005761	5	0	0	0	5
OG0005762	2	1	1	1	5
OG0005763	1	1	1	2	5
OG0005764	3	1	0	1	5
OG0005765	4	0	0	1	5
OG0005766	3	1	0	1	5
OG0005767	2	1	1	1	5
OG0005768	2	1	1	1	5
OG0005769	2	1	1	1	5
OG0005770	2	1	1	1	5
OG0005771	2	1	1	1	5
OG0005772	5	0	0	0	5
OG0005773	2	1	1	1	5
OG0005774	2	1	1	1	5
OG0005775	2	1	1	1	5
OG0005776	5	0	0	0	5
OG0005777	1	0	0	4	5
OG0005778	2	0	0	3	5
OG0005779	3	0	1	1	5
OG0005780	3	0	0	2	5
OG0005781	5	0	0	0	5
OG0005782	5	0	0	0	5
OG0005783	3	0	0	2	5
OG0005784	5	0	0	0	5
OG0005785	1	0	0	4	5
OG0005786	4	0	0	1	5
OG0005787	4	0	0	1	5
OG0005788	5	0	0	0	5
OG0005789	2	1	1	1	5
OG0005790	5	0	0	0	5
OG0005791	4	0	0	1	5
OG0005792	5	0	0	0	5
OG0005793	5	0	0	0	5
OG0005794	2	0	0	3	5
OG0005795	2	0	0	3	5
OG0005796	5	0	0	0	5
OG0005797	2	0	1	2	5
OG0005798	2	0	0	3	5
OG0005799	1	3	1	0	5
OG0005800	2	1	1	1	5
OG0005801	4	1	0	0	5
OG0005802	3	0	1	1	5
OG0005803	2	1	1	1	5
OG0005804	2	0	2	1	5
OG0005805	3	0	0	2	5
OG0005806	3	1	0	1	5
OG0005807	5	0	0	0	5
OG0005808	5	0	0	0	5
OG0005809	5	0	0	0	5
OG0005810	5	0	0	0	5
OG0005811	3	0	1	1	5
OG0005812	3	0	0	2	5
OG0005813	4	0	0	1	5
OG0005814	5	0	0	0	5
OG0005815	2	1	1	1	5
OG0005816	2	0	2	1	5
OG0005817	2	1	1	1	5
OG0005818	2	1	0	2	5
OG0005819	1	0	0	4	5
OG0005820	2	1	1	1	5
OG0005821	3	0	1	1	5
OG0005822	2	1	1	1	5
OG0005823	1	0	0	4	5
OG0005824	5	0	0	0	5
OG0005825	1	1	1	2	5
OG0005826	2	1	1	1	5
OG0005827	5	0	0	0	5
OG0005828	2	1	1	1	5
OG0005829	2	0	2	1	5
OG0005830	5	0	0	0	5
OG0005831	3	0	0	2	5
OG0005832	2	1	1	1	5
OG0005833	2	0	1	2	5
OG0005834	3	1	0	1	5
OG0005835	5	0	0	0	5
OG0005836	5	0	0	0	5
OG0005837	2	0	0	3	5
OG0005838	5	0	0	0	5
OG0005839	5	0	0	0	5
OG0005840	5	0	0	0	5
OG0005841	2	0	2	1	5
OG0005842	5	0	0	0	5
OG0005843	2	2	0	1	5
OG0005844	4	0	0	1	5
OG0005845	2	0	0	3	5
OG0005846	2	1	0	2	5
OG0005847	5	0	0	0	5
OG0005848	3	1	0	1	5
OG0005849	2	1	1	1	5
OG0005850	3	0	1	1	5
OG0005851	3	1	0	1	5
OG0005852	5	0	0	0	5
OG0005853	3	0	0	2	5
OG0005854	2	1	1	1	5
OG0005855	5	0	0	0	5
OG0005856	2	1	1	1	5
OG0005857	2	0	0	3	5
OG0005858	3	0	0	2	5
OG0005859	2	1	1	1	5
OG0005860	5	0	0	0	5
OG0005861	3	1	0	1	5
OG0005862	3	0	1	1	5
OG0005863	3	1	0	1	5
OG0005864	2	1	1	1	5
OG0005865	2	1	1	1	5
OG0005866	2	1	1	1	5
OG0005867	2	1	1	1	5
OG0005868	2	1	1	1	5
OG0005869	5	0	0	0	5
OG0005870	4	1	0	0	5
OG0005871	5	0	0	0	5
OG0005872	3	0	1	1	5
OG0005873	2	2	0	1	5
OG0005874	5	0	0	0	5
OG0005875	5	0	0	0	5
OG0005876	5	0	0	0	5
OG0005877	5	0	0	0	5
OG0005878	4	0	0	1	5
OG0005879	5	0	0	0	5
OG0005880	5	0	0	0	5
OG0005881	5	0	0	0	5
OG0005882	2	0	1	2	5
OG0005883	5	0	0	0	5
OG0005884	5	0	0	0	5
OG0005885	3	2	0	0	5
OG0005886	2	0	2	1	5
OG0005887	1	0	0	4	5
OG0005888	5	0	0	0	5
OG0005889	2	0	0	3	5
OG0005890	2	1	1	1	5
OG0005891	5	0	0	0	5
OG0005892	2	1	1	1	5
OG0005893	1	0	0	4	5
OG0005894	4	0	0	1	5
OG0005895	2	1	1	1	5
OG0005896	2	1	1	1	5
OG0005897	5	0	0	0	5
OG0005898	5	0	0	0	5
OG0005899	3	1	0	1	5
OG0005900	5	0	0	0	5
OG0005901	3	1	0	1	5
OG0005902	1	2	1	1	5
OG0005903	5	0	0	0	5
OG0005904	2	3	0	0	5
OG0005905	4	0	0	1	5
OG0005906	5	0	0	0	5
OG0005907	2	1	0	2	5
OG0005908	2	1	1	1	5
OG0005909	4	0	0	1	5
OG0005910	2	1	1	1	5
OG0005911	2	0	0	3	5
OG0005912	1	2	1	1	5
OG0005913	2	1	1	1	5
OG0005914	3	0	0	2	5
OG0005915	2	1	1	1	5
OG0005916	2	1	0	2	5
OG0005917	3	1	1	0	5
OG0005918	2	1	1	1	5
OG0005919	5	0	0	0	5
OG0005920	4	0	0	1	5
OG0005921	4	0	0	1	5
OG0005922	2	0	2	1	5
OG0005923	2	1	1	1	5
OG0005924	2	1	1	1	5
OG0005925	5	0	0	0	5
OG0005926	3	2	0	0	5
OG0005927	1	3	0	1	5
OG0005928	4	0	0	1	5
OG0005929	5	0	0	0	5
OG0005930	2	1	1	1	5
OG0005931	2	0	0	3	5
OG0005932	2	1	1	1	5
OG0005933	5	0	0	0	5
OG0005934	4	1	0	0	5
OG0005935	1	0	0	4	5
OG0005936	3	0	0	2	5
OG0005937	5	0	0	0	5
OG0005938	5	0	0	0	5
OG0005939	4	0	1	0	5
OG0005940	2	1	0	2	5
OG0005941	3	1	0	1	5
OG0005942	2	2	0	1	5
OG0005943	2	1	1	1	5
OG0005944	4	0	0	1	5
OG0005945	5	0	0	0	5
OG0005946	2	0	1	2	5
OG0005947	2	1	1	1	5
OG0005948	5	0	0	0	5
OG0005949	3	1	0	1	5
OG0005950	5	0	0	0	5
OG0005951	2	1	1	1	5
OG0005952	5	0	0	0	5
OG0005953	2	1	1	1	5
OG0005954	4	0	0	1	5
OG0005955	2	0	0	3	5
OG0005956	5	0	0	0	5
OG0005957	2	1	1	1	5
OG0005958	2	2	0	1	5
OG0005959	3	0	1	1	5
OG0005960	5	0	0	0	5
OG0005961	3	1	0	1	5
OG0005962	2	1	1	1	5
OG0005963	5	0	0	0	5
OG0005964	2	1	1	1	5
OG0005965	5	0	0	0	5
OG0005966	3	0	0	2	5
OG0005967	5	0	0	0	5
OG0005968	3	0	1	1	5
OG0005969	1	2	1	1	5
OG0005970	2	1	1	1	5
OG0005971	2	1	1	1	5
OG0005972	2	1	1	1	5
OG0005973	2	0	1	2	5
OG0005974	5	0	0	0	5
OG0005975	5	0	0	0	5
OG0005976	5	0	0	0	5
OG0005977	2	1	1	1	5
OG0005978	5	0	0	0	5
OG0005979	2	1	1	1	5
OG0005980	5	0	0	0	5
OG0005981	2	2	0	1	5
OG0005982	5	0	0	0	5
OG0005983	2	1	1	1	5
OG0005984	5	0	0	0	5
OG0005985	4	0	0	1	5
OG0005986	4	0	0	1	5
OG0005987	1	0	0	4	5
OG0005988	2	1	1	1	5
OG0005989	4	0	0	1	5
OG0005990	3	0	0	2	5
OG0005991	2	1	1	1	5
OG0005992	3	1	0	1	5
OG0005993	1	1	0	3	5
OG0005994	2	1	1	1	5
OG0005995	5	0	0	0	5
OG0005996	2	1	1	1	5
OG0005997	5	0	0	0	5
OG0005998	2	1	1	1	5
OG0005999	5	0	0	0	5
OG0006000	2	1	1	1	5
OG0006001	3	1	0	1	5
OG0006002	2	1	1	1	5
OG0006003	2	1	1	1	5
OG0006004	5	0	0	0	5
OG0006005	2	0	1	2	5
OG0006006	3	1	0	1	5
OG0006007	4	0	0	1	5
OG0006008	2	1	1	1	5
OG0006009	5	0	0	0	5
OG0006010	5	0	0	0	5
OG0006011	2	1	1	1	5
OG0006012	2	1	0	2	5
OG0006013	3	0	0	2	5
OG0006014	3	1	0	1	5
OG0006015	4	0	0	1	5
OG0006016	4	0	0	1	5
OG0006017	3	0	0	2	5
OG0006018	2	1	1	1	5
OG0006019	1	0	0	4	5
OG0006020	1	1	3	0	5
OG0006021	2	1	1	1	5
OG0006022	3	0	0	2	5
OG0006023	5	0	0	0	5
OG0006024	2	1	1	1	5
OG0006025	1	4	0	0	5
OG0006026	4	0	0	1	5
OG0006027	5	0	0	0	5
OG0006028	2	0	0	3	5
OG0006029	5	0	0	0	5
OG0006030	2	1	1	1	5
OG0006031	2	1	1	1	5
OG0006032	5	0	0	0	5
OG0006033	2	1	1	1	5
OG0006034	5	0	0	0	5
OG0006035	2	1	1	1	5
OG0006036	2	1	1	1	5
OG0006037	3	1	0	1	5
OG0006038	3	0	0	2	5
OG0006039	2	1	1	1	5
OG0006040	2	1	1	1	5
OG0006041	4	0	0	1	5
OG0006042	2	2	0	1	5
OG0006043	2	1	1	1	5
OG0006044	5	0	0	0	5
OG0006045	2	1	1	1	5
OG0006046	5	0	0	0	5
OG0006047	2	1	1	1	5
OG0006048	3	1	0	1	5
OG0006049	3	1	0	1	5
OG0006050	2	1	1	1	5
OG0006051	3	0	0	2	5
OG0006052	2	1	1	1	5
OG0006053	4	0	1	0	5
OG0006054	1	0	0	4	5
OG0006055	2	1	1	1	5
OG0006056	5	0	0	0	5
OG0006057	2	0	0	3	5
OG0006058	3	0	0	2	5
OG0006059	4	0	0	1	5
OG0006060	4	1	0	0	5
OG0006061	2	1	1	1	5
OG0006062	5	0	0	0	5
OG0006063	2	1	1	1	5
OG0006064	5	0	0	0	5
OG0006065	4	0	0	1	5
OG0006066	5	0	0	0	5
OG0006067	2	0	0	3	5
OG0006068	2	1	1	1	5
OG0006069	2	0	1	2	5
OG0006070	2	1	1	1	5
OG0006071	3	0	0	2	5
OG0006072	3	0	0	2	5
OG0006073	2	1	1	1	5
OG0006074	3	1	0	1	5
OG0006075	1	0	0	4	5
OG0006076	5	0	0	0	5
OG0006077	2	2	0	1	5
OG0006078	3	1	0	1	5
OG0006079	3	1	0	1	5
OG0006080	2	1	1	1	5
OG0006081	2	1	1	1	5
OG0006082	5	0	0	0	5
OG0006083	3	0	1	1	5
OG0006084	2	1	1	1	5
OG0006085	5	0	0	0	5
OG0006086	3	0	0	2	5
OG0006087	2	0	0	3	5
OG0006088	2	1	1	1	5
OG0006089	4	0	1	0	5
OG0006090	5	0	0	0	5
OG0006091	5	0	0	0	5
OG0006092	4	0	0	1	5
OG0006093	2	2	0	1	5
OG0006094	3	1	0	1	5
OG0006095	2	1	1	1	5
OG0006096	2	1	1	1	5
OG0006097	2	0	0	3	5
OG0006098	5	0	0	0	5
OG0006099	1	0	0	4	5
OG0006100	2	1	0	2	5
OG0006101	2	1	1	1	5
OG0006102	5	0	0	0	5
OG0006103	5	0	0	0	5
OG0006104	5	0	0	0	5
OG0006105	2	0	0	3	5
OG0006106	2	1	1	1	5
OG0006107	5	0	0	0	5
OG0006108	5	0	0	0	5
OG0006109	4	1	0	0	5
OG0006110	2	2	0	1	5
OG0006111	2	0	0	3	5
OG0006112	5	0	0	0	5
OG0006113	4	0	0	1	5
OG0006114	1	0	0	4	5
OG0006115	2	2	0	1	5
OG0006116	2	0	1	2	5
OG0006117	2	1	1	1	5
OG0006118	1	0	0	4	5
OG0006119	3	1	0	1	5
OG0006120	2	1	1	1	5
OG0006121	2	2	0	1	5
OG0006122	2	0	0	3	5
OG0006123	3	1	0	1	5
OG0006124	1	2	0	2	5
OG0006125	2	1	1	1	5
OG0006126	1	1	2	1	5
OG0006127	5	0	0	0	5
OG0006128	2	1	1	1	5
OG0006129	5	0	0	0	5
OG0006130	3	0	0	2	5
OG0006131	2	1	1	1	5
OG0006132	2	1	1	1	5
OG0006133	3	0	0	2	5
OG0006134	2	1	0	2	5
OG0006135	4	0	0	1	5
OG0006136	5	0	0	0	5
OG0006137	5	0	0	0	5
OG0006138	2	1	1	1	5
OG0006139	3	0	0	2	5
OG0006140	3	0	0	2	5
OG0006141	2	1	1	1	5
OG0006142	1	2	1	1	5
OG0006143	2	1	1	1	5
OG0006144	2	1	1	1	5
OG0006145	3	0	0	2	5
OG0006146	1	1	1	2	5
OG0006147	2	1	1	1	5
OG0006148	2	1	1	1	5
OG0006149	5	0	0	0	5
OG0006150	5	0	0	0	5
OG0006151	5	0	0	0	5
OG0006152	4	0	0	1	5
OG0006153	3	0	0	2	5
OG0006154	3	0	0	2	5
OG0006155	2	2	0	1	5
OG0006156	1	0	0	4	5
OG0006157	3	0	0	2	5
OG0006158	2	1	1	1	5
OG0006159	1	1	2	1	5
OG0006160	5	0	0	0	5
OG0006161	3	1	0	1	5
OG0006162	5	0	0	0	5
OG0006163	2	1	0	2	5
OG0006164	2	1	1	1	5
OG0006165	2	1	1	1	5
OG0006166	2	1	1	1	5
OG0006167	2	1	1	1	5
OG0006168	2	1	1	1	5
OG0006169	3	0	0	2	5
OG0006170	2	1	1	1	5
OG0006171	2	2	0	1	5
OG0006172	5	0	0	0	5
OG0006173	5	0	0	0	5
OG0006174	5	0	0	0	5
OG0006175	3	0	0	2	5
OG0006176	5	0	0	0	5
OG0006177	2	3	0	0	5
OG0006178	2	1	1	1	5
OG0006179	4	0	0	1	5
OG0006180	5	0	0	0	5
OG0006181	2	1	1	1	5
OG0006182	5	0	0	0	5
OG0006183	2	1	1	1	5
OG0006184	3	2	0	0	5
OG0006185	3	0	0	2	5
OG0006186	4	0	0	1	5
OG0006187	5	0	0	0	5
OG0006188	4	0	0	1	5
OG0006189	2	1	1	1	5
OG0006190	2	1	0	2	5
OG0006191	5	0	0	0	5
OG0006192	3	0	0	2	5
OG0006193	5	0	0	0	5
OG0006194	4	0	0	1	5
OG0006195	2	1	1	1	5
OG0006196	3	2	0	0	5
OG0006197	2	1	1	1	5
OG0006198	2	0	0	3	5
OG0006199	2	0	0	3	5
OG0006200	2	1	1	1	5
OG0006201	4	0	0	1	5
OG0006202	2	1	0	2	5
OG0006203	4	0	0	1	5
OG0006204	5	0	0	0	5
OG0006205	1	2	1	1	5
OG0006206	5	0	0	0	5
OG0006207	5	0	0	0	5
OG0006208	1	0	0	4	5
OG0006209	4	0	0	1	5
OG0006210	5	0	0	0	5
OG0006211	3	0	0	2	5
OG0006212	2	1	1	1	5
OG0006213	5	0	0	0	5
OG0006214	2	1	0	2	5
OG0006215	5	0	0	0	5
OG0006216	3	0	0	2	5
OG0006217	2	1	1	1	5
OG0006218	5	0	0	0	5
OG0006219	5	0	0	0	5
OG0006220	3	0	0	2	5
OG0006221	4	0	0	1	5
OG0006222	2	2	0	1	5
OG0006223	2	0	1	2	5
OG0006224	4	0	0	1	5
OG0006225	5	0	0	0	5
OG0006226	4	0	0	1	5
OG0006227	2	0	0	3	5
OG0006228	2	1	0	2	5
OG0006229	2	0	0	3	5
OG0006230	3	1	1	0	5
OG0006231	2	1	1	1	5
OG0006232	1	1	1	2	5
OG0006233	2	0	1	2	5
OG0006234	2	1	1	1	5
OG0006235	2	2	0	1	5
OG0006236	3	2	0	0	5
OG0006237	5	0	0	0	5
OG0006238	3	0	1	1	5
OG0006239	2	1	1	1	5
OG0006240	5	0	0	0	5
OG0006241	2	2	0	1	5
OG0006242	2	1	1	1	5
OG0006243	2	1	1	1	5
OG0006244	2	1	1	1	5
OG0006245	1	0	0	4	5
OG0006246	3	0	0	2	5
OG0006247	2	0	1	2	5
OG0006248	2	0	0	3	5
OG0006249	1	0	0	4	5
OG0006250	2	1	1	1	5
OG0006251	2	1	1	1	5
OG0006252	1	1	1	2	5
OG0006253	5	0	0	0	5
OG0006254	5	0	0	0	5
OG0006255	4	0	0	1	5
OG0006256	2	1	1	1	5
OG0006257	1	0	0	4	5
OG0006258	1	1	1	2	5
OG0006259	1	4	0	0	5
OG0006260	5	0	0	0	5
OG0006261	2	1	1	1	5
OG0006262	5	0	0	0	5
OG0006263	3	0	0	2	5
OG0006264	5	0	0	0	5
OG0006265	2	1	1	1	5
OG0006266	2	1	1	1	5
OG0006267	1	2	1	1	5
OG0006268	2	1	1	1	5
OG0006269	2	2	0	1	5
OG0006270	1	0	1	3	5
OG0006271	2	1	1	1	5
OG0006272	3	1	0	1	5
OG0006273	3	0	0	2	5
OG0006274	5	0	0	0	5
OG0006275	4	0	0	1	5
OG0006276	5	0	0	0	5
OG0006277	1	0	0	4	5
OG0006278	2	0	1	2	5
OG0006279	4	0	0	1	5
OG0006280	1	1	2	1	5
OG0006281	3	2	0	0	5
OG0006282	5	0	0	0	5
OG0006283	2	1	1	1	5
OG0006284	2	1	1	1	5
OG0006285	2	1	1	1	5
OG0006286	2	1	1	1	5
OG0006287	2	0	1	2	5
OG0006288	4	0	0	1	5
OG0006289	2	0	1	2	5
OG0006290	3	0	0	2	5
OG0006291	1	2	1	1	5
OG0006292	2	0	0	3	5
OG0006293	5	0	0	0	5
OG0006294	1	1	1	2	5
OG0006295	1	1	1	2	5
OG0006296	5	0	0	0	5
OG0006297	1	4	0	0	5
OG0006298	5	0	0	0	5
OG0006299	1	1	1	2	5
OG0006300	4	0	0	1	5
OG0006301	1	1	0	3	5
OG0006302	1	2	1	1	5
OG0006303	1	0	0	4	5
OG0006304	2	1	1	1	5
OG0006305	5	0	0	0	5
OG0006306	1	2	2	0	5
OG0006307	2	0	0	3	5
OG0006308	5	0	0	0	5
OG0006309	1	0	0	4	5
OG0006310	2	0	2	1	5
OG0006311	1	2	1	1	5
OG0006312	1	1	1	2	5
OG0006313	5	0	0	0	5
OG0006314	1	3	0	1	5
OG0006315	2	0	0	3	5
OG0006316	2	1	1	1	5
OG0006317	5	0	0	0	5
OG0006318	4	0	0	1	5
OG0006319	2	0	0	3	5
OG0006320	2	1	0	2	5
OG0006321	1	1	2	1	5
OG0006322	3	0	0	2	5
OG0006323	2	0	0	3	5
OG0006324	5	0	0	0	5
OG0006325	3	0	1	1	5
OG0006326	5	0	0	0	5
OG0006327	2	0	0	3	5
OG0006328	1	1	1	2	5
OG0006329	1	1	2	1	5
OG0006330	1	1	1	2	5
OG0006331	1	2	1	1	5
OG0006332	1	1	2	1	5
OG0006333	4	0	0	1	5
OG0006334	2	1	2	0	5
OG0006335	2	1	0	2	5
OG0006336	1	1	2	1	5
OG0006337	2	1	0	2	5
OG0006338	1	0	0	4	5
OG0006339	2	1	1	1	5
OG0006340	2	1	1	1	5
OG0006341	2	1	1	1	5
OG0006342	2	1	1	1	5
OG0006343	1	2	1	1	5
OG0006344	2	3	0	0	5
OG0006345	3	0	1	1	5
OG0006346	2	0	0	3	5
OG0006347	3	1	0	1	5
OG0006348	1	1	2	1	5
OG0006349	2	0	0	3	5
OG0006350	3	0	0	2	5
OG0006351	1	2	1	1	5
OG0006352	1	1	1	2	5
OG0006353	1	1	1	2	5
OG0006354	2	1	1	1	5
OG0006355	1	2	1	1	5
OG0006356	2	0	0	3	5
OG0006357	2	1	0	2	5
OG0006358	5	0	0	0	5
OG0006359	1	1	2	1	5
OG0006360	2	1	1	1	5
OG0006361	1	1	2	1	5
OG0006362	5	0	0	0	5
OG0006363	2	0	0	3	5
OG0006364	5	0	0	0	5
OG0006365	2	1	1	1	5
OG0006366	2	0	0	3	5
OG0006367	2	3	0	0	5
OG0006368	1	2	1	1	5
OG0006369	2	1	0	2	5
OG0006370	4	0	0	1	5
OG0006371	1	2	1	1	5
OG0006372	1	1	2	1	5
OG0006373	1	1	1	2	5
OG0006374	1	1	2	1	5
OG0006375	3	0	0	2	5
OG0006376	2	1	1	1	5
OG0006377	1	1	1	2	5
OG0006378	2	0	0	3	5
OG0006379	1	1	2	1	5
OG0006380	1	2	1	1	5
OG0006381	2	0	0	3	5
OG0006382	1	0	0	4	5
OG0006383	1	0	0	4	5
OG0006384	5	0	0	0	5
OG0006385	1	1	1	2	5
OG0006386	1	1	1	2	5
OG0006387	2	1	1	1	5
OG0006388	1	2	1	1	5
OG0006389	1	0	1	3	5
OG0006390	1	0	0	4	5
OG0006391	1	2	1	1	5
OG0006392	2	1	1	1	5
OG0006393	2	1	1	1	5
OG0006394	1	1	2	1	5
OG0006395	1	2	1	1	5
OG0006396	1	2	0	2	5
OG0006397	4	1	0	0	5
OG0006398	1	2	1	1	5
OG0006399	1	0	0	4	5
OG0006400	1	2	1	1	5
OG0006401	1	0	0	4	5
OG0006402	5	0	0	0	5
OG0006403	1	2	1	1	5
OG0006404	2	0	0	3	5
OG0006405	2	1	1	1	5
OG0006406	5	0	0	0	5
OG0006407	1	2	1	1	5
OG0006408	4	0	0	1	5
OG0006409	1	1	2	1	5
OG0006410	1	0	0	4	5
OG0006411	1	1	1	2	5
OG0006412	4	0	0	1	5
OG0006413	1	1	2	1	5
OG0006414	3	0	0	2	5
OG0006415	1	2	1	1	5
OG0006416	1	1	2	1	5
OG0006417	1	0	0	4	5
OG0006418	2	1	0	2	5
OG0006419	1	1	1	2	5
OG0006420	1	1	1	2	5
OG0006421	5	0	0	0	5
OG0006422	2	1	0	2	5
OG0006423	1	1	1	2	5
OG0006424	3	0	0	2	5
OG0006425	3	0	0	2	5
OG0006426	1	1	0	3	5
OG0006427	2	0	0	3	5
OG0006428	1	0	0	4	5
OG0006429	1	1	2	1	5
OG0006430	2	1	1	1	5
OG0006431	1	1	1	2	5
OG0006432	1	1	1	2	5
OG0006433	1	2	1	1	5
OG0006434	2	0	1	2	5
OG0006435	2	1	0	2	5
OG0006436	1	1	2	1	5
OG0006437	1	1	1	2	5
OG0006438	1	2	1	1	5
OG0006439	1	1	2	1	5
OG0006440	1	0	3	1	5
OG0006441	1	1	1	2	5
OG0006442	1	1	1	2	5
OG0006443	1	1	2	1	5
OG0006444	1	2	1	1	5
OG0006445	1	1	1	2	5
OG0006446	1	3	0	1	5
OG0006447	1	2	1	1	5
OG0006448	1	2	1	1	5
OG0006449	2	0	1	2	5
OG0006450	1	2	1	1	5
OG0006451	1	2	1	1	5
OG0006452	2	1	0	2	5
OG0006453	1	2	1	1	5
OG0006454	1	0	0	4	5
OG0006455	1	1	1	2	5
OG0006456	2	0	1	2	5
OG0006457	1	0	2	2	5
OG0006458	1	1	2	1	5
OG0006459	1	1	1	2	5
OG0006460	3	0	0	2	5
OG0006461	1	0	0	4	5
OG0006462	1	0	0	4	5
OG0006463	5	0	0	0	5
OG0006464	1	2	1	1	5
OG0006465	1	2	1	1	5
OG0006466	1	2	1	1	5
OG0006467	1	3	0	1	5
OG0006468	2	0	0	3	5
OG0006469	1	0	3	1	5
OG0006470	1	3	0	1	5
OG0006471	5	0	0	0	5
OG0006472	1	1	2	1	5
OG0006473	1	2	1	1	5
OG0006474	1	1	2	1	5
OG0006475	2	1	1	1	5
OG0006476	5	0	0	0	5
OG0006477	5	0	0	0	5
OG0006478	1	1	2	1	5
OG0006479	1	1	2	1	5
OG0006480	1	2	0	2	5
OG0006481	2	0	0	3	5
OG0006482	5	0	0	0	5
OG0006483	2	1	1	1	5
OG0006484	1	1	2	1	5
OG0006485	1	0	0	4	5
OG0006486	4	0	0	1	5
OG0006487	1	2	0	2	5
OG0006488	1	2	1	1	5
OG0006489	5	0	0	0	5
OG0006490	2	1	1	1	5
OG0006491	1	1	1	2	5
OG0006492	5	0	0	0	5
OG0006493	3	0	0	2	5
OG0006494	1	2	1	1	5
OG0006495	1	1	2	1	5
OG0006496	5	0	0	0	5
OG0006497	1	2	1	1	5
OG0006498	1	2	1	1	5
OG0006499	1	0	0	4	5
OG0006500	1	2	1	1	5
OG0006501	1	2	1	1	5
OG0006502	1	0	0	4	5
OG0006503	1	1	2	1	5
OG0006504	1	3	0	1	5
OG0006505	1	1	1	2	5
OG0006506	1	2	1	1	5
OG0006507	1	2	1	1	5
OG0006508	1	1	2	1	5
OG0006509	4	0	0	1	5
OG0006510	1	2	1	1	5
OG0006511	1	1	2	1	5
OG0006512	2	0	0	3	5
OG0006513	1	1	2	1	5
OG0006514	1	1	2	1	5
OG0006515	1	1	1	2	5
OG0006516	1	1	1	2	5
OG0006517	1	2	1	1	5
OG0006518	1	2	1	1	5
OG0006519	1	1	2	1	5
OG0006520	1	2	1	1	5
OG0006521	1	2	0	2	5
OG0006522	3	1	0	1	5
OG0006523	1	2	1	1	5
OG0006524	1	1	1	2	5
OG0006525	2	1	0	2	5
OG0006526	1	0	0	4	5
OG0006527	1	2	1	1	5
OG0006528	1	2	0	2	5
OG0006529	1	2	1	1	5
OG0006530	1	1	2	1	5
OG0006531	1	1	1	2	5
OG0006532	1	0	2	2	5
OG0006533	5	0	0	0	5
OG0006534	1	1	2	1	5
OG0006535	3	0	0	2	5
OG0006536	1	1	2	1	5
OG0006537	1	1	2	1	5
OG0006538	5	0	0	0	5
OG0006539	3	0	0	2	5
OG0006540	2	1	1	1	5
OG0006541	1	2	1	1	5
OG0006542	1	1	2	1	5
OG0006543	1	0	0	4	5
OG0006544	2	1	1	1	5
OG0006545	1	1	0	3	5
OG0006546	1	1	2	1	5
OG0006547	2	2	0	1	5
OG0006548	5	0	0	0	5
OG0006549	1	0	0	4	5
OG0006550	1	1	1	2	5
OG0006551	1	1	1	2	5
OG0006552	1	1	2	1	5
OG0006553	2	1	1	1	5
OG0006554	1	1	1	2	5
OG0006555	1	1	1	2	5
OG0006556	1	1	2	1	5
OG0006557	1	1	2	1	5
OG0006558	1	1	1	2	5
OG0006559	1	1	1	2	5
OG0006560	1	0	0	4	5
OG0006561	4	0	0	1	5
OG0006562	1	2	1	1	5
OG0006563	1	2	1	1	5
OG0006564	1	4	0	0	5
OG0006565	1	1	0	3	5
OG0006566	1	1	2	1	5
OG0006567	1	1	1	2	5
OG0006568	1	2	0	2	5
OG0006569	1	0	0	4	5
OG0006570	1	2	1	1	5
OG0006571	1	2	1	1	5
OG0006572	1	2	1	1	5
OG0006573	1	2	1	1	5
OG0006574	1	0	0	4	5
OG0006575	1	2	0	2	5
OG0006576	1	1	1	2	5
OG0006577	5	0	0	0	5
OG0006578	1	2	1	1	5
OG0006579	2	1	1	1	5
OG0006580	1	2	1	1	5
OG0006581	2	2	0	1	5
OG0006582	1	1	1	2	5
OG0006583	5	0	0	0	5
OG0006584	1	2	1	1	5
OG0006585	1	1	2	1	5
OG0006586	1	2	1	1	5
OG0006587	1	0	0	4	5
OG0006588	1	1	2	1	5
OG0006589	1	1	2	1	5
OG0006590	3	1	0	1	5
OG0006591	1	2	1	1	5
OG0006592	1	1	2	1	5
OG0006593	1	2	1	1	5
OG0006594	1	1	1	2	5
OG0006595	1	1	2	1	5
OG0006596	1	1	2	1	5
OG0006597	1	1	1	2	5
OG0006598	1	1	2	1	5
OG0006599	2	1	0	2	5
OG0006600	1	1	1	2	5
OG0006601	1	1	1	2	5
OG0006602	1	1	1	2	5
OG0006603	1	1	1	2	5
OG0006604	1	1	2	1	5
OG0006605	1	2	1	1	5
OG0006606	1	2	0	2	5
OG0006607	1	0	2	2	5
OG0006608	1	0	1	3	5
OG0006609	1	1	2	1	5
OG0006610	1	2	1	1	5
OG0006611	1	1	1	2	5
OG0006612	1	1	2	1	5
OG0006613	1	1	1	2	5
OG0006614	2	1	0	2	5
OG0006615	1	1	1	2	5
OG0006616	1	1	1	2	5
OG0006617	1	2	1	1	5
OG0006618	1	2	1	1	5
OG0006619	3	1	0	1	5
OG0006620	1	0	2	2	5
OG0006621	1	1	1	2	5
OG0006622	1	1	1	2	5
OG0006623	3	0	1	1	5
OG0006624	1	1	1	2	5
OG0006625	1	2	1	1	5
OG0006626	1	1	2	1	5
OG0006627	2	1	1	1	5
OG0006628	1	1	2	1	5
OG0006629	1	1	2	1	5
OG0006630	2	1	1	1	5
OG0006631	1	1	2	1	5
OG0006632	1	1	2	1	5
OG0006633	1	2	1	1	5
OG0006634	1	1	2	1	5
OG0006635	1	1	1	2	5
OG0006636	2	1	1	1	5
OG0006637	1	2	1	1	5
OG0006638	2	1	1	1	5
OG0006639	1	1	2	1	5
OG0006640	1	1	0	3	5
OG0006641	2	2	0	1	5
OG0006642	1	0	0	4	5
OG0006643	1	2	1	1	5
OG0006644	1	1	2	1	5
OG0006645	2	1	0	2	5
OG0006646	1	2	0	2	5
OG0006647	1	0	0	4	5
OG0006648	1	1	1	2	5
OG0006649	1	1	1	2	5
OG0006650	1	1	1	2	5
OG0006651	1	1	1	2	5
OG0006652	1	3	0	1	5
OG0006653	2	0	0	3	5
OG0006654	2	3	0	0	5
OG0006655	1	2	1	1	5
OG0006656	1	1	1	2	5
OG0006657	1	1	1	2	5
OG0006658	1	1	2	1	5
OG0006659	1	1	2	1	5
OG0006660	3	1	0	1	5
OG0006661	1	0	0	4	5
OG0006662	1	1	2	1	5
OG0006663	2	1	0	2	5
OG0006664	1	2	1	1	5
OG0006665	1	1	2	1	5
OG0006666	1	1	2	1	5
OG0006667	1	1	1	2	5
OG0006668	1	2	0	2	5
OG0006669	1	1	1	2	5
OG0006670	1	0	0	4	5
OG0006671	1	2	1	1	5
OG0006672	1	2	1	1	5
OG0006673	1	0	3	1	5
OG0006674	1	0	0	4	5
OG0006675	1	1	2	1	5
OG0006676	1	2	1	1	5
OG0006677	1	1	1	2	5
OG0006678	1	0	3	1	5
OG0006679	1	1	2	1	5
OG0006680	1	1	2	1	5
OG0006681	1	1	2	1	5
OG0006682	1	3	0	1	5
OG0006683	1	2	1	1	5
OG0006684	1	1	2	1	5
OG0006685	2	2	0	1	5
OG0006686	4	0	0	1	5
OG0006687	1	2	1	1	5
OG0006688	1	2	1	1	5
OG0006689	1	2	1	1	5
OG0006690	2	0	0	3	5
OG0006691	1	0	3	1	5
OG0006692	1	1	1	2	5
OG0006693	1	2	1	1	5
OG0006694	1	0	1	3	5
OG0006695	1	1	1	2	5
OG0006696	1	1	2	1	5
OG0006697	1	1	2	1	5
OG0006698	1	1	2	1	5
OG0006699	2	0	0	3	5
OG0006700	1	2	1	1	5
OG0006701	1	1	2	1	5
OG0006702	1	1	2	1	5
OG0006703	2	0	1	2	5
OG0006704	1	1	2	1	5
OG0006705	1	1	1	2	5
OG0006706	1	1	1	2	5
OG0006707	1	1	2	1	5
OG0006708	2	3	0	0	5
OG0006709	1	1	1	2	5
OG0006710	1	1	1	2	5
OG0006711	2	3	0	0	5
OG0006712	1	1	1	2	5
OG0006713	1	1	1	2	5
OG0006714	1	1	2	1	5
OG0006715	1	1	1	2	5
OG0006716	1	2	1	1	5
OG0006717	1	1	0	3	5
OG0006718	1	1	2	1	5
OG0006719	2	1	0	2	5
OG0006720	2	0	0	3	5
OG0006721	1	2	1	1	5
OG0006722	1	1	1	2	5
OG0006723	2	0	0	3	5
OG0006724	2	1	1	1	5
OG0006725	2	1	0	2	5
OG0006726	1	1	2	1	5
OG0006727	1	0	3	1	5
OG0006728	2	0	0	3	5
OG0006729	1	1	1	2	5
OG0006730	1	1	2	1	5
OG0006731	1	2	0	2	5
OG0006732	1	2	1	1	5
OG0006733	1	0	0	4	5
OG0006734	1	2	1	1	5
OG0006735	1	1	2	1	5
OG0006736	2	0	0	3	5
OG0006737	1	2	1	1	5
OG0006738	1	2	1	1	5
OG0006739	1	2	1	1	5
OG0006740	1	2	1	1	5
OG0006741	1	1	1	2	5
OG0006742	2	1	1	1	5
OG0006743	1	1	2	1	5
OG0006744	1	1	2	1	5
OG0006745	1	0	0	4	5
OG0006746	1	1	1	2	5
OG0006747	1	2	1	1	5
OG0006748	1	2	1	1	5
OG0006749	1	1	2	1	5
OG0006750	1	2	1	1	5
OG0006751	1	2	1	1	5
OG0006752	1	1	1	2	5
OG0006753	1	1	2	1	5
OG0006754	1	0	1	3	5
OG0006755	1	1	2	1	5
OG0006756	1	2	1	1	5
OG0006757	1	0	0	4	5
OG0006758	1	1	2	1	5
OG0006759	1	1	1	2	5
OG0006760	1	2	1	1	5
OG0006761	2	1	1	1	5
OG0006762	1	2	1	1	5
OG0006763	1	1	2	1	5
OG0006764	1	1	1	2	5
OG0006765	1	2	1	1	5
OG0006766	1	0	3	1	5
OG0006767	1	0	3	1	5
OG0006768	1	1	2	1	5
OG0006769	1	2	1	1	5
OG0006770	1	1	2	1	5
OG0006771	1	1	2	1	5
OG0006772	1	0	3	1	5
OG0006773	1	2	1	1	5
OG0006774	1	1	2	1	5
OG0006775	1	2	1	1	5
OG0006776	1	1	2	1	5
OG0006777	1	0	0	4	5
OG0006778	1	2	1	1	5
OG0006779	1	1	1	2	5
OG0006780	1	2	1	1	5
OG0006781	2	0	1	2	5
OG0006782	1	0	2	2	5
OG0006783	2	1	1	1	5
OG0006784	1	1	2	1	5
OG0006785	2	0	0	3	5
OG0006786	1	1	1	2	5
OG0006787	1	1	1	2	5
OG0006788	1	1	1	2	5
OG0006789	1	1	1	2	5
OG0006790	1	0	0	4	5
OG0006791	1	0	0	4	5
OG0006792	1	1	1	2	5
OG0006793	1	1	1	2	5
OG0006794	1	1	1	2	5
OG0006795	1	0	2	2	5
OG0006796	1	1	1	2	5
OG0006797	1	1	0	3	5
OG0006798	1	0	1	3	5
OG0006799	1	1	2	1	5
OG0006800	1	2	1	1	5
OG0006801	1	1	1	2	5
OG0006802	1	1	0	3	5
OG0006803	1	1	2	1	5
OG0006804	1	0	0	4	5
OG0006805	1	2	1	1	5
OG0006806	1	1	1	2	5
OG0006807	1	1	2	1	5
OG0006808	1	2	1	1	5
OG0006809	1	1	2	1	5
OG0006810	1	2	1	1	5
OG0006811	1	2	1	1	5
OG0006812	1	2	1	1	5
OG0006813	1	0	0	4	5
OG0006814	1	1	1	2	5
OG0006815	1	2	0	2	5
OG0006816	1	1	2	1	5
OG0006817	1	1	2	1	5
OG0006818	1	1	2	1	5
OG0006819	1	0	0	4	5
OG0006820	2	0	2	1	5
OG0006821	1	2	1	1	5
OG0006822	1	2	1	1	5
OG0006823	1	2	0	2	5
OG0006824	1	1	1	2	5
OG0006825	1	1	1	2	5
OG0006826	1	2	1	1	5
OG0006827	1	2	1	1	5
OG0006828	2	1	1	1	5
OG0006829	1	0	0	4	5
OG0006830	1	0	0	4	5
OG0006831	1	1	1	2	5
OG0006832	1	2	1	1	5
OG0006833	1	1	2	1	5
OG0006834	1	2	1	1	5
OG0006835	1	2	1	1	5
OG0006836	1	1	2	1	5
OG0006837	1	1	1	2	5
OG0006838	1	2	1	1	5
OG0006839	1	1	2	1	5
OG0006840	1	1	1	2	5
OG0006841	1	1	1	2	5
OG0006842	2	1	0	2	5
OG0006843	2	0	0	3	5
OG0006844	1	0	0	4	5
OG0006845	1	1	2	1	5
OG0006846	4	0	0	1	5
OG0006847	3	0	0	2	5
OG0006848	1	1	2	1	5
OG0006849	1	1	2	1	5
OG0006850	2	1	0	2	5
OG0006851	1	2	0	2	5
OG0006852	1	1	1	2	5
OG0006853	1	2	1	1	5
OG0006854	1	3	0	1	5
OG0006855	1	2	1	1	5
OG0006856	1	2	1	1	5
OG0006857	1	1	2	1	5
OG0006858	1	1	2	1	5
OG0006859	1	2	1	1	5
OG0006860	1	2	1	1	5
OG0006861	1	2	1	1	5
OG0006862	1	2	1	1	5
OG0006863	1	1	1	2	5
OG0006864	1	1	1	2	5
OG0006865	1	2	1	1	5
OG0006866	1	2	1	1	5
OG0006867	2	1	0	2	5
OG0006868	2	0	0	3	5
OG0006869	5	0	0	0	5
OG0006870	1	2	1	1	5
OG0006871	1	2	1	1	5
OG0006872	1	1	2	1	5
OG0006873	1	2	1	1	5
OG0006874	1	1	2	1	5
OG0006875	1	2	1	1	5
OG0006876	1	2	1	1	5
OG0006877	1	0	0	4	5
OG0006878	1	1	2	1	5
OG0006879	1	2	0	2	5
OG0006880	1	1	2	1	5
OG0006881	1	1	1	2	5
OG0006882	1	0	3	1	5
OG0006883	1	1	2	1	5
OG0006884	1	2	1	1	5
OG0006885	1	1	1	2	5
OG0006886	1	1	2	1	5
OG0006887	1	1	2	1	5
OG0006888	1	2	0	2	5
OG0006889	1	1	1	2	5
OG0006890	1	1	2	1	5
OG0006891	1	1	2	1	5
OG0006892	1	1	2	1	5
OG0006893	1	2	1	1	5
OG0006894	1	1	1	2	5
OG0006895	1	2	1	1	5
OG0006896	2	0	0	3	5
OG0006897	1	1	2	1	5
OG0006898	1	1	2	1	5
OG0006899	1	1	1	2	5
OG0006900	1	1	1	2	5
OG0006901	1	2	1	1	5
OG0006902	2	1	1	1	5
OG0006903	1	2	1	1	5
OG0006904	1	2	1	1	5
OG0006905	1	3	0	1	5
OG0006906	1	3	0	1	5
OG0006907	1	2	1	1	5
OG0006908	1	1	1	2	5
OG0006909	1	1	1	2	5
OG0006910	1	2	1	1	5
OG0006911	1	1	1	2	5
OG0006912	1	2	1	1	5
OG0006913	1	2	1	1	5
OG0006914	1	1	2	1	5
OG0006915	1	2	0	2	5
OG0006916	1	1	1	2	5
OG0006917	1	2	1	1	5
OG0006918	2	1	0	2	5
OG0006919	2	0	2	1	5
OG0006920	1	1	2	1	5
OG0006921	2	1	1	1	5
OG0006922	1	1	2	1	5
OG0006923	2	1	1	1	5
OG0006924	1	1	1	2	5
OG0006925	1	1	2	1	5
OG0006926	1	2	1	1	5
OG0006927	1	2	0	2	5
OG0006928	1	2	1	1	5
OG0006929	1	2	1	1	5
OG0006930	2	0	0	3	5
OG0006931	1	3	0	1	5
OG0006932	1	0	0	4	5
OG0006933	1	1	0	3	5
OG0006934	1	2	1	1	5
OG0006935	1	1	1	2	5
OG0006936	1	2	1	1	5
OG0006937	1	1	2	1	5
OG0006938	1	2	1	1	5
OG0006939	1	1	2	1	5
OG0006940	1	2	1	1	5
OG0006941	1	2	1	1	5
OG0006942	1	0	2	2	5
OG0006943	1	1	1	2	5
OG0006944	2	0	0	3	5
OG0006945	1	2	1	1	5
OG0006946	1	1	2	1	5
OG0006947	1	1	1	2	5
OG0006948	1	2	1	1	5
OG0006949	1	1	1	2	5
OG0006950	1	2	1	1	5
OG0006951	4	0	0	1	5
OG0006952	1	1	2	1	5
OG0006953	1	1	2	1	5
OG0006954	1	1	2	1	5
OG0006955	2	1	0	2	5
OG0006956	1	2	1	1	5
OG0006957	1	1	2	1	5
OG0006958	1	2	1	1	5
OG0006959	1	1	2	1	5
OG0006960	3	2	0	0	5
OG0006961	1	0	0	4	5
OG0006962	1	4	0	0	5
OG0006963	1	2	1	1	5
OG0006964	1	2	1	1	5
OG0006965	1	2	1	1	5
OG0006966	1	1	2	1	5
OG0006967	1	0	0	4	5
OG0006968	1	2	1	1	5
OG0006969	1	1	1	2	5
OG0006970	2	1	1	1	5
OG0006971	1	1	1	2	5
OG0006972	1	2	1	1	5
OG0006973	1	2	1	1	5
OG0006974	1	1	2	1	5
OG0006975	1	1	2	1	5
OG0006976	1	2	1	1	5
OG0006977	1	1	1	2	5
OG0006978	1	1	1	2	5
OG0006979	1	0	0	4	5
OG0006980	1	1	1	2	5
OG0006981	1	1	1	2	5
OG0006982	1	1	1	2	5
OG0006983	1	2	1	1	5
OG0006984	1	1	2	1	5
OG0006985	1	1	2	1	5
OG0006986	1	2	2	0	5
OG0006987	1	1	1	2	5
OG0006988	2	2	0	1	5
OG0006989	1	0	3	1	5
OG0006990	1	3	0	1	5
OG0006991	1	2	1	1	5
OG0006992	2	0	0	3	5
OG0006993	1	0	0	4	5
OG0006994	1	2	1	1	5
OG0006995	1	2	1	1	5
OG0006996	1	1	2	1	5
OG0006997	1	2	1	1	5
OG0006998	1	0	1	3	5
OG0006999	1	2	1	1	5
OG0007000	1	1	2	1	5
OG0007001	1	2	1	1	5
OG0007002	1	3	0	1	5
OG0007003	1	1	1	2	5
OG0007004	1	0	0	4	5
OG0007005	1	1	2	1	5
OG0007006	5	0	0	0	5
OG0007007	1	1	2	1	5
OG0007008	1	2	0	2	5
OG0007009	1	1	0	3	5
OG0007010	1	1	2	1	5
OG0007011	1	2	1	1	5
OG0007012	1	1	2	1	5
OG0007013	1	1	1	2	5
OG0007014	1	2	1	1	5
OG0007015	1	1	1	2	5
OG0007016	1	0	1	3	5
OG0007017	1	1	2	1	5
OG0007018	5	0	0	0	5
OG0007019	1	0	0	4	5
OG0007020	1	2	1	1	5
OG0007021	1	2	1	1	5
OG0007022	1	1	1	2	5
OG0007023	1	1	1	2	5
OG0007024	1	0	2	2	5
OG0007025	1	1	0	3	5
OG0007026	1	1	2	1	5
OG0007027	1	1	2	1	5
OG0007028	4	0	0	1	5
OG0007029	1	0	3	1	5
OG0007030	1	1	2	1	5
OG0007031	1	1	1	2	5
OG0007032	1	1	2	1	5
OG0007033	1	1	2	1	5
OG0007034	1	2	1	1	5
OG0007035	1	2	1	1	5
OG0007036	1	2	1	1	5
OG0007037	1	2	1	1	5
OG0007038	4	1	0	0	5
OG0007039	1	2	1	1	5
OG0007040	1	2	1	1	5
OG0007041	1	2	1	1	5
OG0007042	1	2	1	1	5
OG0007043	1	1	1	2	5
OG0007044	1	2	1	1	5
OG0007045	2	0	0	3	5
OG0007046	1	2	1	1	5
OG0007047	1	2	1	1	5
OG0007048	2	0	2	1	5
OG0007049	1	0	0	4	5
OG0007050	1	2	1	1	5
OG0007051	1	2	1	1	5
OG0007052	1	2	1	1	5
OG0007053	1	1	2	1	5
OG0007054	1	1	1	2	5
OG0007055	1	2	1	1	5
OG0007056	1	1	2	1	5
OG0007057	1	2	1	1	5
OG0007058	1	3	0	1	5
OG0007059	1	2	1	1	5
OG0007060	1	1	1	2	5
OG0007061	1	1	2	1	5
OG0007062	1	1	2	1	5
OG0007063	1	2	1	1	5
OG0007064	1	2	1	1	5
OG0007065	1	1	2	1	5
OG0007066	1	2	1	1	5
OG0007067	1	2	1	1	5
OG0007068	1	2	1	1	5
OG0007069	2	0	0	3	5
OG0007070	2	1	1	1	5
OG0007071	1	2	1	1	5
OG0007072	1	2	1	1	5
OG0007073	1	0	1	3	5
OG0007074	1	1	2	1	5
OG0007075	1	1	1	2	5
OG0007076	1	1	1	2	5
OG0007077	1	2	1	1	5
OG0007078	1	1	2	1	5
OG0007079	1	2	1	1	5
OG0007080	1	1	2	1	5
OG0007081	1	3	0	1	5
OG0007082	2	2	0	1	5
OG0007083	1	1	1	2	5
OG0007084	1	1	2	1	5
OG0007085	1	0	3	1	5
OG0007086	1	3	0	1	5
OG0007087	1	2	1	1	5
OG0007088	1	1	2	1	5
OG0007089	1	1	1	2	5
OG0007090	1	0	0	4	5
OG0007091	1	0	0	4	5
OG0007092	1	1	1	2	5
OG0007093	1	1	2	1	5
OG0007094	1	1	2	1	5
OG0007095	1	1	2	1	5
OG0007096	1	1	2	1	5
OG0007097	1	1	1	2	5
OG0007098	1	1	1	2	5
OG0007099	1	2	0	2	5
OG0007100	1	2	1	1	5
OG0007101	1	1	2	1	5
OG0007102	1	0	0	4	5
OG0007103	1	2	1	1	5
OG0007104	1	2	1	1	5
OG0007105	1	0	0	4	5
OG0007106	1	1	2	1	5
OG0007107	1	0	0	4	5
OG0007108	1	2	1	1	5
OG0007109	1	2	0	2	5
OG0007110	2	0	1	2	5
OG0007111	1	1	1	2	5
OG0007112	1	2	1	1	5
OG0007113	1	2	1	1	5
OG0007114	1	1	1	2	5
OG0007115	1	2	1	1	5
OG0007116	1	1	2	1	5
OG0007117	1	0	3	1	5
OG0007118	1	0	0	4	5
OG0007119	1	1	2	1	5
OG0007120	1	0	0	4	5
OG0007121	1	1	1	2	5
OG0007122	1	1	2	1	5
OG0007123	1	0	3	1	5
OG0007124	1	1	1	2	5
OG0007125	1	2	1	1	5
OG0007126	1	2	1	1	5
OG0007127	1	2	1	1	5
OG0007128	1	1	2	1	5
OG0007129	1	1	0	3	5
OG0007130	1	1	2	1	5
OG0007131	1	1	1	2	5
OG0007132	1	1	1	2	5
OG0007133	1	1	2	1	5
OG0007134	1	2	1	1	5
OG0007135	1	2	1	1	5
OG0007136	1	1	2	1	5
OG0007137	1	1	2	1	5
OG0007138	1	1	1	2	5
OG0007139	1	2	1	1	5
OG0007140	1	1	2	1	5
OG0007141	1	1	1	2	5
OG0007142	1	2	1	1	5
OG0007143	1	1	2	1	5
OG0007144	1	2	1	1	5
OG0007145	1	2	1	1	5
OG0007146	1	2	1	1	5
OG0007147	1	2	1	1	5
OG0007148	1	2	1	1	5
OG0007149	1	2	1	1	5
OG0007150	1	1	1	2	5
OG0007151	1	2	1	1	5
OG0007152	2	1	1	1	5
OG0007153	1	2	1	1	5
OG0007154	1	3	0	1	5
OG0007155	1	1	1	2	5
OG0007156	1	0	0	4	5
OG0007157	1	2	1	1	5
OG0007158	1	2	1	1	5
OG0007159	1	2	1	1	5
OG0007160	1	1	2	1	5
OG0007161	1	1	1	2	5
OG0007162	1	3	0	1	5
OG0007163	1	2	0	2	5
OG0007164	2	0	2	1	5
OG0007165	1	2	1	1	5
OG0007166	1	1	1	2	5
OG0007167	1	1	2	1	5
OG0007168	1	0	1	3	5
OG0007169	1	2	1	1	5
OG0007170	1	1	1	2	5
OG0007171	1	1	2	1	5
OG0007172	1	1	2	1	5
OG0007173	1	2	1	1	5
OG0007174	1	1	2	1	5
OG0007175	2	1	1	1	5
OG0007176	1	1	1	2	5
OG0007177	1	1	2	1	5
OG0007178	2	0	0	3	5
OG0007179	1	1	2	1	5
OG0007180	1	2	1	1	5
OG0007181	1	3	0	1	5
OG0007182	1	1	1	2	5
OG0007183	1	1	2	1	5
OG0007184	1	2	1	1	5
OG0007185	1	2	2	0	5
OG0007186	1	2	1	1	5
OG0007187	1	2	1	1	5
OG0007188	1	2	1	1	5
OG0007189	1	2	1	1	5
OG0007190	1	1	0	3	5
OG0007191	1	1	2	1	5
OG0007192	1	2	1	1	5
OG0007193	1	1	1	2	5
OG0007194	1	2	1	1	5
OG0007195	1	2	1	1	5
OG0007196	1	0	3	1	5
OG0007197	2	2	0	1	5
OG0007198	1	1	1	2	5
OG0007199	1	2	1	1	5
OG0007200	1	1	2	1	5
OG0007201	1	1	2	1	5
OG0007202	1	1	2	1	5
OG0007203	1	2	1	1	5
OG0007204	1	1	2	1	5
OG0007205	1	2	1	1	5
OG0007206	1	1	2	1	5
OG0007207	1	1	2	1	5
OG0007208	1	1	2	1	5
OG0007209	1	2	1	1	5
OG0007210	1	2	1	1	5
OG0007211	1	1	2	1	5
OG0007212	1	2	1	1	5
OG0007213	1	2	1	1	5
OG0007214	2	1	1	1	5
OG0007215	1	1	1	2	5
OG0007216	1	1	2	1	5
OG0007217	1	2	1	1	5
OG0007218	2	1	0	2	5
OG0007219	1	2	1	1	5
OG0007220	1	2	1	1	5
OG0007221	1	2	1	1	5
OG0007222	2	0	2	1	5
OG0007223	1	1	2	1	5
OG0007224	1	1	1	2	5
OG0007225	1	2	1	1	5
OG0007226	1	2	1	1	5
OG0007227	1	2	1	1	5
OG0007228	1	1	1	2	5
OG0007229	1	1	2	1	5
OG0007230	1	1	2	1	5
OG0007231	1	1	1	2	5
OG0007232	1	1	2	1	5
OG0007233	1	1	2	1	5
OG0007234	1	2	1	1	5
OG0007235	1	2	1	1	5
OG0007236	1	2	1	1	5
OG0007237	1	1	2	1	5
OG0007238	1	1	1	2	5
OG0007239	1	1	1	2	5
OG0007240	1	2	1	1	5
OG0007241	1	0	2	2	5
OG0007242	1	2	1	1	5
OG0007243	1	1	1	2	5
OG0007244	1	3	0	1	5
OG0007245	1	2	1	1	5
OG0007246	2	0	1	2	5
OG0007247	1	2	1	1	5
OG0007248	1	2	1	1	5
OG0007249	1	1	1	2	5
OG0007250	1	1	2	1	5
OG0007251	1	2	1	1	5
OG0007252	1	1	2	1	5
OG0007253	2	1	1	1	5
OG0007254	1	2	1	1	5
OG0007255	1	2	1	1	5
OG0007256	1	2	1	1	5
OG0007257	1	1	2	1	5
OG0007258	1	2	1	1	5
OG0007259	1	1	2	1	5
OG0007260	1	1	2	1	5
OG0007261	1	1	2	1	5
OG0007262	1	2	1	1	5
OG0007263	1	1	2	1	5
OG0007264	1	1	2	1	5
OG0007265	1	1	2	1	5
OG0007266	1	2	1	1	5
OG0007267	1	1	1	2	5
OG0007268	1	1	2	1	5
OG0007269	1	1	2	1	5
OG0007270	1	3	0	1	5
OG0007271	1	3	0	1	5
OG0007272	1	1	1	2	5
OG0007273	1	1	1	2	5
OG0007274	1	1	1	2	5
OG0007275	3	0	0	2	5
OG0007276	1	2	1	1	5
OG0007277	2	1	1	1	5
OG0007278	1	2	1	1	5
OG0007279	1	1	1	2	5
OG0007280	1	1	1	2	5
OG0007281	1	2	1	1	5
OG0007282	1	0	3	1	5
OG0007283	1	2	1	1	5
OG0007284	1	1	2	1	5
OG0007285	1	1	1	2	5
OG0007286	1	1	1	2	5
OG0007287	1	2	1	1	5
OG0007288	1	4	0	0	5
OG0007289	1	2	1	1	5
OG0007290	1	2	1	1	5
OG0007291	1	2	1	1	5
OG0007292	1	2	1	1	5
OG0007293	1	1	1	2	5
OG0007294	2	0	0	3	5
OG0007295	1	2	1	1	5
OG0007296	1	2	1	1	5
OG0007297	1	2	0	2	5
OG0007298	1	2	0	2	5
OG0007299	1	2	1	1	5
OG0007300	1	2	1	1	5
OG0007301	1	2	1	1	5
OG0007302	1	1	2	1	5
OG0007303	1	3	0	1	5
OG0007304	2	1	1	1	5
OG0007305	2	1	1	1	5
OG0007306	1	0	0	4	5
OG0007307	1	1	2	1	5
OG0007308	1	0	0	4	5
OG0007309	1	2	1	1	5
OG0007310	1	1	2	1	5
OG0007311	1	2	1	1	5
OG0007312	2	1	1	1	5
OG0007313	2	0	2	1	5
OG0007314	1	1	2	1	5
OG0007315	1	1	1	2	5
OG0007316	1	1	2	1	5
OG0007317	1	1	2	1	5
OG0007318	1	3	0	1	5
OG0007319	1	2	1	1	5
OG0007320	1	2	1	1	5
OG0007321	1	2	1	1	5
OG0007322	1	1	2	1	5
OG0007323	1	1	1	2	5
OG0007324	1	2	1	1	5
OG0007325	1	2	1	1	5
OG0007326	1	2	1	1	5
OG0007327	1	2	1	1	5
OG0007328	1	1	1	2	5
OG0007329	1	2	1	1	5
OG0007330	1	2	1	1	5
OG0007331	1	2	1	1	5
OG0007332	1	1	1	2	5
OG0007333	2	0	0	3	5
OG0007334	1	1	2	1	5
OG0007335	1	2	1	1	5
OG0007336	1	2	1	1	5
OG0007337	1	1	2	1	5
OG0007338	2	1	0	2	5
OG0007339	2	0	0	3	5
OG0007340	1	2	1	1	5
OG0007341	1	0	0	4	5
OG0007342	1	2	0	2	5
OG0007343	1	1	2	1	5
OG0007344	1	1	2	1	5
OG0007345	1	1	2	1	5
OG0007346	1	0	0	4	5
OG0007347	1	2	1	1	5
OG0007348	1	0	0	4	5
OG0007349	1	2	1	1	5
OG0007350	1	0	3	1	5
OG0007351	1	0	3	1	5
OG0007352	1	1	1	2	5
OG0007353	1	2	1	1	5
OG0007354	1	1	2	1	5
OG0007355	1	2	1	1	5
OG0007356	1	1	2	1	5
OG0007357	1	2	1	1	5
OG0007358	1	2	1	1	5
OG0007359	1	1	2	1	5
OG0007360	1	1	1	2	5
OG0007361	1	1	1	2	5
OG0007362	1	2	1	1	5
OG0007363	1	1	2	1	5
OG0007364	1	1	1	2	5
OG0007365	1	2	1	1	5
OG0007366	1	2	1	1	5
OG0007367	1	0	1	3	5
OG0007368	1	2	1	1	5
OG0007369	2	1	1	1	5
OG0007370	1	1	0	3	5
OG0007371	1	1	2	1	5
OG0007372	1	1	2	1	5
OG0007373	1	2	1	1	5
OG0007374	1	0	0	4	5
OG0007375	1	0	0	4	5
OG0007376	2	1	1	1	5
OG0007377	1	1	2	1	5
OG0007378	1	1	1	2	5
OG0007379	1	1	2	1	5
OG0007380	1	2	1	1	5
OG0007381	1	2	1	1	5
OG0007382	1	1	1	2	5
OG0007383	1	1	2	1	5
OG0007384	1	2	1	1	5
OG0007385	1	1	0	3	5
OG0007386	1	1	1	2	5
OG0007387	1	1	2	1	5
OG0007388	1	1	1	2	5
OG0007389	1	2	0	2	5
OG0007390	1	1	2	1	5
OG0007391	1	0	1	3	5
OG0007392	2	1	1	1	5
OG0007393	1	1	2	1	5
OG0007394	1	1	2	1	5
OG0007395	1	2	1	1	5
OG0007396	1	2	1	1	5
OG0007397	1	2	1	1	5
OG0007398	1	2	1	1	5
OG0007399	1	3	0	1	5
OG0007400	1	1	2	1	5
OG0007401	1	1	2	1	5
OG0007402	1	2	1	1	5
OG0007403	2	1	1	1	5
OG0007404	1	2	1	1	5
OG0007405	1	1	2	1	5
OG0007406	1	1	1	2	5
OG0007407	1	1	2	1	5
OG0007408	1	0	3	1	5
OG0007409	1	1	2	1	5
OG0007410	1	1	1	2	5
OG0007411	1	2	1	1	5
OG0007412	1	2	1	1	5
OG0007413	1	2	1	1	5
OG0007414	1	1	2	1	5
OG0007415	1	2	1	1	5
OG0007416	1	0	3	1	5
OG0007417	1	1	2	1	5
OG0007418	2	1	1	1	5
OG0007419	1	2	1	1	5
OG0007420	1	1	2	1	5
OG0007421	1	2	0	2	5
OG0007422	1	1	2	1	5
OG0007423	1	2	1	1	5
OG0007424	1	1	2	1	5
OG0007425	1	2	1	1	5
OG0007426	1	1	2	1	5
OG0007427	1	2	1	1	5
OG0007428	1	2	1	1	5
OG0007429	1	3	1	0	5
OG0007430	1	1	2	1	5
OG0007431	2	1	0	2	5
OG0007432	1	1	1	2	5
OG0007433	1	2	0	2	5
OG0007434	1	0	3	1	5
OG0007435	1	2	1	1	5
OG0007436	1	2	1	1	5
OG0007437	1	1	1	2	5
OG0007438	2	1	1	1	5
OG0007439	1	1	1	2	5
OG0007440	1	2	1	1	5
OG0007441	1	1	1	2	5
OG0007442	1	0	0	4	5
OG0007443	1	1	2	1	5
OG0007444	1	2	1	1	5
OG0007445	1	2	1	1	5
OG0007446	2	1	1	1	5
OG0007447	1	1	0	3	5
OG0007448	2	1	1	1	5
OG0007449	1	1	1	2	5
OG0007450	1	1	2	1	5
OG0007451	1	3	0	1	5
OG0007452	1	2	1	1	5
OG0007453	1	1	2	1	5
OG0007454	1	1	2	1	5
OG0007455	1	1	1	2	5
OG0007456	1	1	1	2	5
OG0007457	1	1	2	1	5
OG0007458	1	0	0	4	5
OG0007459	1	2	1	1	5
OG0007460	1	2	1	1	5
OG0007461	1	1	2	1	5
OG0007462	1	1	2	1	5
OG0007463	1	1	1	2	5
OG0007464	1	1	1	2	5
OG0007465	1	3	0	1	5
OG0007466	1	1	1	2	5
OG0007467	1	1	2	1	5
OG0007468	1	2	1	1	5
OG0007469	1	2	1	1	5
OG0007470	2	1	0	2	5
OG0007471	1	1	1	2	5
OG0007472	1	1	1	2	5
OG0007473	1	1	2	1	5
OG0007474	1	1	2	1	5
OG0007475	1	2	1	1	5
OG0007476	1	1	1	2	5
OG0007477	1	2	1	1	5
OG0007478	1	1	1	2	5
OG0007479	1	2	1	1	5
OG0007480	1	1	2	1	5
OG0007481	1	1	2	1	5
OG0007482	2	1	1	1	5
OG0007483	1	1	1	2	5
OG0007484	1	2	1	1	5
OG0007485	1	0	0	4	5
OG0007486	1	1	2	1	5
OG0007487	1	1	2	1	5
OG0007488	1	1	2	1	5
OG0007489	1	1	1	2	5
OG0007490	1	2	1	1	5
OG0007491	1	1	1	2	5
OG0007492	1	1	0	3	5
OG0007493	1	2	1	1	5
OG0007494	1	2	1	1	5
OG0007495	1	2	1	1	5
OG0007496	1	1	0	3	5
OG0007497	1	2	1	1	5
OG0007498	1	1	1	2	5
OG0007499	1	2	1	1	5
OG0007500	1	2	1	1	5
OG0007501	1	1	2	1	5
OG0007502	1	2	1	1	5
OG0007503	1	1	2	1	5
OG0007504	1	1	2	1	5
OG0007505	1	2	1	1	5
OG0007506	1	2	0	2	5
OG0007507	1	2	1	1	5
OG0007508	2	1	1	1	5
OG0007509	1	1	2	1	5
OG0007510	1	2	1	1	5
OG0007511	1	1	1	2	5
OG0007512	1	0	0	4	5
OG0007513	1	2	1	1	5
OG0007514	1	1	1	2	5
OG0007515	1	1	0	3	5
OG0007516	1	3	0	1	5
OG0007517	1	0	3	1	5
OG0007518	1	1	1	2	5
OG0007519	1	1	2	1	5
OG0007520	2	1	1	1	5
OG0007521	1	1	2	1	5
OG0007522	1	2	1	1	5
OG0007523	1	1	1	2	5
OG0007524	1	1	2	1	5
OG0007525	1	1	2	1	5
OG0007526	1	1	1	2	5
OG0007527	1	1	1	2	5
OG0007528	1	1	2	1	5
OG0007529	1	1	2	1	5
OG0007530	1	1	2	1	5
OG0007531	1	1	2	1	5
OG0007532	1	1	2	1	5
OG0007533	1	0	3	1	5
OG0007534	1	1	2	1	5
OG0007535	1	1	1	2	5
OG0007536	2	0	2	1	5
OG0007537	1	2	1	1	5
OG0007538	1	2	1	1	5
OG0007539	1	1	2	1	5
OG0007540	1	1	1	2	5
OG0007541	1	2	1	1	5
OG0007542	1	2	1	1	5
OG0007543	1	2	1	1	5
OG0007544	1	2	1	1	5
OG0007545	1	1	2	1	5
OG0007546	1	1	2	1	5
OG0007547	2	2	0	1	5
OG0007548	1	1	2	1	5
OG0007549	1	1	2	1	5
OG0007550	1	2	1	1	5
OG0007551	2	1	1	1	5
OG0007552	1	1	2	1	5
OG0007553	1	0	3	1	5
OG0007554	1	2	1	1	5
OG0007555	1	2	1	1	5
OG0007556	1	0	2	2	5
OG0007557	1	1	2	1	5
OG0007558	1	0	3	1	5
OG0007559	1	1	2	1	5
OG0007560	1	1	2	1	5
OG0007561	1	1	1	2	5
OG0007562	1	2	1	1	5
OG0007563	1	2	1	1	5
OG0007564	1	1	1	2	5
OG0007565	1	1	2	1	5
OG0007566	1	1	1	2	5
OG0007567	1	1	1	2	5
OG0007568	1	1	1	2	5
OG0007569	1	1	2	1	5
OG0007570	1	2	0	2	5
OG0007571	1	1	2	1	5
OG0007572	1	1	1	2	5
OG0007573	2	1	1	1	5
OG0007574	1	2	1	1	5
OG0007575	1	2	1	1	5
OG0007576	1	1	2	1	5
OG0007577	1	3	0	1	5
OG0007578	1	1	2	1	5
OG0007579	1	2	1	1	5
OG0007580	1	1	2	1	5
OG0007581	1	0	3	1	5
OG0007582	1	2	1	1	5
OG0007583	1	0	3	1	5
OG0007584	1	0	1	3	5
OG0007585	1	2	1	1	5
OG0007586	1	3	0	1	5
OG0007587	1	2	1	1	5
OG0007588	2	0	0	3	5
OG0007589	1	1	2	1	5
OG0007590	1	2	1	1	5
OG0007591	1	1	1	2	5
OG0007592	1	0	0	4	5
OG0007593	1	2	1	1	5
OG0007594	1	1	2	1	5
OG0007595	1	1	1	2	5
OG0007596	1	1	2	1	5
OG0007597	1	3	0	1	5
OG0007598	1	2	1	1	5
OG0007599	1	0	0	4	5
OG0007600	1	1	1	2	5
OG0007601	1	1	1	2	5
OG0007602	1	1	2	1	5
OG0007603	2	0	0	3	5
OG0007604	1	2	1	1	5
OG0007605	1	1	1	2	5
OG0007606	1	2	1	1	5
OG0007607	1	1	2	1	5
OG0007608	1	2	1	1	5
OG0007609	1	1	1	2	5
OG0007610	1	1	2	1	5
OG0007611	1	3	0	1	5
OG0007612	1	1	2	1	5
OG0007613	1	1	1	2	5
OG0007614	1	1	0	3	5
OG0007615	1	1	2	1	5
OG0007616	1	1	1	2	5
OG0007617	1	1	1	2	5
OG0007618	1	2	1	1	5
OG0007619	1	1	1	2	5
OG0007620	1	2	1	1	5
OG0007621	1	1	1	2	5
OG0007622	1	1	0	3	5
OG0007623	2	1	1	1	5
OG0007624	2	0	0	3	5
OG0007625	1	1	0	3	5
OG0007626	1	0	0	4	5
OG0007627	1	1	2	1	5
OG0007628	1	2	1	1	5
OG0007629	1	0	0	4	5
OG0007630	1	2	1	1	5
OG0007631	1	1	1	2	5
OG0007632	1	2	1	1	5
OG0007633	1	1	1	2	5
OG0007634	1	1	2	1	5
OG0007635	1	1	1	2	5
OG0007636	2	1	1	1	5
OG0007637	2	0	0	3	5
OG0007638	1	1	2	1	5
OG0007639	1	1	1	2	5
OG0007640	1	0	1	3	5
OG0007641	1	1	1	2	5
OG0007642	1	1	1	2	5
OG0007643	1	3	0	1	5
OG0007644	1	0	2	2	5
OG0007645	1	1	2	1	5
OG0007646	1	1	1	2	5
OG0007647	1	1	2	1	5
OG0007648	1	3	0	1	5
OG0007649	1	1	1	2	5
OG0007650	1	2	1	1	5
OG0007651	1	1	2	1	5
OG0007652	1	2	0	2	5
OG0007653	1	1	2	1	5
OG0007654	1	2	1	1	5
OG0007655	2	1	1	1	5
OG0007656	1	2	1	1	5
OG0007657	1	2	0	2	5
OG0007658	1	2	1	1	5
OG0007659	1	2	1	1	5
OG0007660	1	2	1	1	5
OG0007661	1	2	1	1	5
OG0007662	1	2	1	1	5
OG0007663	1	1	1	2	5
OG0007664	1	1	2	1	5
OG0007665	1	1	1	2	5
OG0007666	1	2	1	1	5
OG0007667	1	2	1	1	5
OG0007668	1	1	1	2	5
OG0007669	1	1	2	1	5
OG0007670	1	2	1	1	5
OG0007671	1	2	1	1	5
OG0007672	1	2	1	1	5
OG0007673	1	0	1	3	5
OG0007674	1	1	2	1	5
OG0007675	1	2	1	1	5
OG0007676	1	1	2	1	5
OG0007677	1	2	1	1	5
OG0007678	1	1	1	2	5
OG0007679	1	2	1	1	5
OG0007680	1	2	1	1	5
OG0007681	1	1	1	2	5
OG0007682	1	3	0	1	5
OG0007683	1	1	2	1	5
OG0007684	1	1	2	1	5
OG0007685	1	3	0	1	5
OG0007686	1	2	1	1	5
OG0007687	1	1	2	1	5
OG0007688	1	1	1	2	5
OG0007689	1	2	1	1	5
OG0007690	1	1	2	1	5
OG0007691	1	2	1	1	5
OG0007692	1	2	1	1	5
OG0007693	1	1	1	2	5
OG0007694	1	1	1	2	5
OG0007695	1	1	2	1	5
OG0007696	1	1	2	1	5
OG0007697	1	1	2	1	5
OG0007698	1	1	2	1	5
OG0007699	1	2	1	1	5
OG0007700	1	0	3	1	5
OG0007701	1	1	2	1	5
OG0007702	1	1	2	1	5
OG0007703	1	1	1	2	5
OG0007704	1	2	1	1	5
OG0007705	1	1	2	1	5
OG0007706	1	2	1	1	5
OG0007707	1	1	2	1	5
OG0007708	1	2	1	1	5
OG0007709	1	2	1	1	5
OG0007710	3	0	0	2	5
OG0007711	1	1	1	2	5
OG0007712	1	1	0	3	5
OG0007713	1	1	2	1	5
OG0007714	1	1	2	1	5
OG0007715	1	2	1	1	5
OG0007716	1	1	2	1	5
OG0007717	1	2	1	1	5
OG0007718	2	1	1	1	5
OG0007719	1	1	2	1	5
OG0007720	1	0	2	2	5
OG0007721	1	0	3	1	5
OG0007722	1	0	0	4	5
OG0007723	1	3	0	1	5
OG0007724	1	1	1	2	5
OG0007725	1	2	1	1	5
OG0007726	1	2	1	1	5
OG0007727	1	2	1	1	5
OG0007728	1	2	0	2	5
OG0007729	1	2	1	1	5
OG0007730	1	1	2	1	5
OG0007731	1	2	1	1	5
OG0007732	1	1	2	1	5
OG0007733	1	1	2	1	5
OG0007734	1	1	2	1	5
OG0007735	1	1	1	2	5
OG0007736	1	2	1	1	5
OG0007737	1	2	1	1	5
OG0007738	1	1	2	1	5
OG0007739	1	2	1	1	5
OG0007740	1	2	1	1	5
OG0007741	1	1	1	2	5
OG0007742	1	1	1	2	5
OG0007743	1	2	1	1	5
OG0007744	1	1	2	1	5
OG0007745	1	2	1	1	5
OG0007746	1	1	2	1	5
OG0007747	1	2	1	1	5
OG0007748	2	1	2	0	5
OG0007749	1	0	0	4	5
OG0007750	1	1	1	2	5
OG0007751	1	1	1	2	5
OG0007752	1	2	1	1	5
OG0007753	2	0	0	3	5
OG0007754	1	3	0	1	5
OG0007755	1	2	1	1	5
OG0007756	1	2	1	1	5
OG0007757	1	1	0	3	5
OG0007758	1	2	1	1	5
OG0007759	1	1	2	1	5
OG0007760	1	2	1	1	5
OG0007761	1	1	2	1	5
OG0007762	0	5	0	0	5
OG0007763	0	5	0	0	5
OG0007764	0	5	0	0	5
OG0007765	0	5	0	0	5
OG0007766	0	5	0	0	5
OG0007767	0	5	0	0	5
OG0007768	0	5	0	0	5
OG0007769	0	5	0	0	5
OG0007770	0	5	0	0	5
OG0007771	0	4	1	0	5
OG0007772	0	5	0	0	5
OG0007773	0	2	0	3	5
OG0007774	0	5	0	0	5
OG0007775	0	1	0	4	5
OG0007776	0	5	0	0	5
OG0007777	0	5	0	0	5
OG0007778	0	5	0	0	5
OG0007779	0	5	0	0	5
OG0007780	0	5	0	0	5
OG0007781	0	5	0	0	5
OG0007782	0	5	0	0	5
OG0007783	0	5	0	0	5
OG0007784	0	5	0	0	5
OG0007785	0	5	0	0	5
OG0007786	0	5	0	0	5
OG0007787	0	5	0	0	5
OG0007788	0	2	2	1	5
OG0007789	0	5	0	0	5
OG0007790	0	5	0	0	5
OG0007791	0	5	0	0	5
OG0007792	0	5	0	0	5
OG0007793	0	5	0	0	5
OG0007794	0	5	0	0	5
OG0007795	0	5	0	0	5
OG0007796	0	5	0	0	5
OG0007797	0	5	0	0	5
OG0007798	0	5	0	0	5
OG0007799	0	5	0	0	5
OG0007800	0	5	0	0	5
OG0007801	0	5	0	0	5
OG0007802	0	5	0	0	5
OG0007803	0	5	0	0	5
OG0007804	0	5	0	0	5
OG0007805	0	5	0	0	5
OG0007806	0	5	0	0	5
OG0007807	0	5	0	0	5
OG0007808	0	5	0	0	5
OG0007809	0	5	0	0	5
OG0007810	0	5	0	0	5
OG0007811	0	5	0	0	5
OG0007812	0	5	0	0	5
OG0007813	0	5	0	0	5
OG0007814	0	5	0	0	5
OG0007815	0	5	0	0	5
OG0007816	0	5	0	0	5
OG0007817	0	5	0	0	5
OG0007818	0	5	0	0	5
OG0007819	0	5	0	0	5
OG0007820	0	5	0	0	5
OG0007821	0	5	0	0	5
OG0007822	0	5	0	0	5
OG0007823	0	5	0	0	5
OG0007824	0	4	1	0	5
OG0007825	0	5	0	0	5
OG0007826	0	5	0	0	5
OG0007827	0	5	0	0	5
OG0007828	0	5	0	0	5
OG0007829	0	5	0	0	5
OG0007830	0	5	0	0	5
OG0007831	0	5	0	0	5
OG0007832	0	5	0	0	5
OG0007833	0	5	0	0	5
OG0007834	0	5	0	0	5
OG0007835	0	5	0	0	5
OG0007836	0	5	0	0	5
OG0007837	0	5	0	0	5
OG0007838	0	5	0	0	5
OG0007839	0	5	0	0	5
OG0007840	0	5	0	0	5
OG0007841	0	5	0	0	5
OG0007842	0	5	0	0	5
OG0007843	0	5	0	0	5
OG0007844	0	5	0	0	5
OG0007845	0	5	0	0	5
OG0007846	0	5	0	0	5
OG0007847	0	5	0	0	5
OG0007848	0	5	0	0	5
OG0007849	0	5	0	0	5
OG0007850	0	5	0	0	5
OG0007851	0	5	0	0	5
OG0007852	0	5	0	0	5
OG0007853	0	5	0	0	5
OG0007854	0	5	0	0	5
OG0007855	0	5	0	0	5
OG0007856	0	5	0	0	5
OG0007857	0	5	0	0	5
OG0007858	0	5	0	0	5
OG0007859	0	5	0	0	5
OG0007860	0	5	0	0	5
OG0007861	0	5	0	0	5
OG0007862	0	4	0	1	5
OG0007863	0	5	0	0	5
OG0007864	0	2	0	3	5
OG0007865	0	3	0	2	5
OG0007866	0	5	0	0	5
OG0007867	0	5	0	0	5
OG0007868	0	3	0	2	5
OG0007869	0	5	0	0	5
OG0007870	0	5	0	0	5
OG0007871	0	5	0	0	5
OG0007872	0	5	0	0	5
OG0007873	0	5	0	0	5
OG0007874	0	5	0	0	5
OG0007875	0	5	0	0	5
OG0007876	0	5	0	0	5
OG0007877	0	5	0	0	5
OG0007878	0	5	0	0	5
OG0007879	0	5	0	0	5
OG0007880	0	5	0	0	5
OG0007881	0	5	0	0	5
OG0007882	0	5	0	0	5
OG0007883	0	5	0	0	5
OG0007884	0	5	0	0	5
OG0007885	0	3	2	0	5
OG0007886	0	5	0	0	5
OG0007887	0	5	0	0	5
OG0007888	0	5	0	0	5
OG0007889	0	5	0	0	5
OG0007890	0	1	0	4	5
OG0007891	0	5	0	0	5
OG0007892	0	5	0	0	5
OG0007893	0	5	0	0	5
OG0007894	0	5	0	0	5
OG0007895	0	4	0	1	5
OG0007896	0	5	0	0	5
OG0007897	0	1	3	1	5
OG0007898	0	5	0	0	5
OG0007899	0	5	0	0	5
OG0007900	0	2	2	1	5
OG0007901	0	4	1	0	5
OG0007902	0	5	0	0	5
OG0007903	0	5	0	0	5
OG0007904	0	5	0	0	5
OG0007905	0	5	0	0	5
OG0007906	0	5	0	0	5
OG0007907	0	5	0	0	5
OG0007908	0	5	0	0	5
OG0007909	0	5	0	0	5
OG0007910	0	5	0	0	5
OG0007911	0	5	0	0	5
OG0007912	0	5	0	0	5
OG0007913	0	5	0	0	5
OG0007914	0	5	0	0	5
OG0007915	0	5	0	0	5
OG0007916	0	5	0	0	5
OG0007917	0	2	3	0	5
OG0007918	0	5	0	0	5
OG0007919	0	5	0	0	5
OG0007920	0	5	0	0	5
OG0007921	0	5	0	0	5
OG0007922	0	5	0	0	5
OG0007923	0	5	0	0	5
OG0007924	0	5	0	0	5
OG0007925	0	5	0	0	5
OG0007926	0	5	0	0	5
OG0007927	0	5	0	0	5
OG0007928	0	5	0	0	5
OG0007929	0	4	1	0	5
OG0007930	0	5	0	0	5
OG0007931	0	5	0	0	5
OG0007932	0	5	0	0	5
OG0007933	0	4	1	0	5
OG0007934	0	5	0	0	5
OG0007935	0	5	0	0	5
OG0007936	0	5	0	0	5
OG0007937	0	5	0	0	5
OG0007938	0	3	1	1	5
OG0007939	0	5	0	0	5
OG0007940	0	5	0	0	5
OG0007941	0	5	0	0	5
OG0007942	0	5	0	0	5
OG0007943	0	5	0	0	5
OG0007944	0	5	0	0	5
OG0007945	0	2	2	1	5
OG0007946	0	1	1	3	5
OG0007947	0	5	0	0	5
OG0007948	0	5	0	0	5
OG0007949	0	5	0	0	5
OG0007950	0	5	0	0	5
OG0007951	0	5	0	0	5
OG0007952	0	5	0	0	5
OG0007953	0	5	0	0	5
OG0007954	0	5	0	0	5
OG0007955	0	5	0	0	5
OG0007956	0	5	0	0	5
OG0007957	0	5	0	0	5
OG0007958	0	3	2	0	5
OG0007959	0	5	0	0	5
OG0007960	0	5	0	0	5
OG0007961	0	5	0	0	5
OG0007962	0	1	0	4	5
OG0007963	0	5	0	0	5
OG0007964	0	5	0	0	5
OG0007965	0	5	0	0	5
OG0007966	0	4	1	0	5
OG0007967	0	5	0	0	5
OG0007968	0	5	0	0	5
OG0007969	0	5	0	0	5
OG0007970	0	2	1	2	5
OG0007971	0	5	0	0	5
OG0007972	0	1	2	2	5
OG0007973	0	4	1	0	5
OG0007974	0	5	0	0	5
OG0007975	0	5	0	0	5
OG0007976	0	5	0	0	5
OG0007977	0	5	0	0	5
OG0007978	0	5	0	0	5
OG0007979	0	1	1	3	5
OG0007980	0	3	1	1	5
OG0007981	0	5	0	0	5
OG0007982	0	5	0	0	5
OG0007983	0	3	1	1	5
OG0007984	0	5	0	0	5
OG0007985	0	5	0	0	5
OG0007986	0	5	0	0	5
OG0007987	0	4	1	0	5
OG0007988	0	5	0	0	5
OG0007989	0	5	0	0	5
OG0007990	0	5	0	0	5
OG0007991	0	5	0	0	5
OG0007992	0	1	3	1	5
OG0007993	0	1	0	4	5
OG0007994	0	5	0	0	5
OG0007995	0	1	4	0	5
OG0007996	0	5	0	0	5
OG0007997	0	5	0	0	5
OG0007998	0	4	0	1	5
OG0007999	0	3	1	1	5
OG0008000	0	5	0	0	5
OG0008001	0	1	0	4	5
OG0008002	0	5	0	0	5
OG0008003	0	4	1	0	5
OG0008004	0	5	0	0	5
OG0008005	0	5	0	0	5
OG0008006	0	5	0	0	5
OG0008007	0	5	0	0	5
OG0008008	0	5	0	0	5
OG0008009	0	5	0	0	5
OG0008010	0	1	0	4	5
OG0008011	0	1	3	1	5
OG0008012	0	5	0	0	5
OG0008013	0	3	0	2	5
OG0008014	0	0	5	0	5
OG0008015	0	0	5	0	5
OG0008016	0	0	5	0	5
OG0008017	0	0	5	0	5
OG0008018	0	0	5	0	5
OG0008019	0	0	5	0	5
OG0008020	0	0	5	0	5
OG0008021	0	0	5	0	5
OG0008022	0	0	5	0	5
OG0008023	0	0	5	0	5
OG0008024	0	0	5	0	5
OG0008025	0	0	5	0	5
OG0008026	0	0	5	0	5
OG0008027	0	0	5	0	5
OG0008028	0	0	5	0	5
OG0008029	0	0	5	0	5
OG0008030	0	0	5	0	5
OG0008031	0	0	5	0	5
OG0008032	0	0	5	0	5
OG0008033	0	0	5	0	5
OG0008034	0	0	5	0	5
OG0008035	0	0	5	0	5
OG0008036	0	0	5	0	5
OG0008037	0	0	5	0	5
OG0008038	0	0	5	0	5
OG0008039	0	0	5	0	5
OG0008040	0	0	5	0	5
OG0008041	0	0	5	0	5
OG0008042	0	0	5	0	5
OG0008043	0	0	5	0	5
OG0008044	0	0	5	0	5
OG0008045	0	0	5	0	5
OG0008046	0	0	5	0	5
OG0008047	0	0	5	0	5
OG0008048	0	0	5	0	5
OG0008049	0	0	5	0	5
OG0008050	0	0	5	0	5
OG0008051	0	0	5	0	5
OG0008052	0	0	5	0	5
OG0008053	0	0	5	0	5
OG0008054	0	0	5	0	5
OG0008055	0	0	5	0	5
OG0008056	0	0	5	0	5
OG0008057	0	0	5	0	5
OG0008058	0	0	5	0	5
OG0008059	0	0	5	0	5
OG0008060	0	0	5	0	5
OG0008061	0	0	5	0	5
OG0008062	0	0	5	0	5
OG0008063	0	0	5	0	5
OG0008064	0	0	5	0	5
OG0008065	0	0	5	0	5
OG0008066	0	0	5	0	5
OG0008067	0	0	5	0	5
OG0008068	0	0	5	0	5
OG0008069	0	0	5	0	5
OG0008070	0	0	5	0	5
OG0008071	0	0	5	0	5
OG0008072	0	0	5	0	5
OG0008073	0	0	5	0	5
OG0008074	0	0	5	0	5
OG0008075	0	0	5	0	5
OG0008076	0	0	5	0	5
OG0008077	0	0	5	0	5
OG0008078	0	0	5	0	5
OG0008079	0	0	5	0	5
OG0008080	0	0	5	0	5
OG0008081	0	0	5	0	5
OG0008082	0	0	5	0	5
OG0008083	0	0	5	0	5
OG0008084	0	0	5	0	5
OG0008085	0	0	5	0	5
OG0008086	0	0	5	0	5
OG0008087	0	0	5	0	5
OG0008088	0	0	5	0	5
OG0008089	0	0	5	0	5
OG0008090	0	0	5	0	5
OG0008091	0	0	5	0	5
OG0008092	0	0	5	0	5
OG0008093	0	0	5	0	5
OG0008094	0	0	5	0	5
OG0008095	0	0	5	0	5
OG0008096	0	0	5	0	5
OG0008097	0	0	5	0	5
OG0008098	0	0	5	0	5
OG0008099	0	0	5	0	5
OG0008100	0	0	5	0	5
OG0008101	0	0	5	0	5
OG0008102	0	0	5	0	5
OG0008103	0	0	5	0	5
OG0008104	0	0	5	0	5
OG0008105	0	0	5	0	5
OG0008106	0	0	5	0	5
OG0008107	0	0	0	5	5
OG0008108	0	0	0	5	5
OG0008109	0	0	0	5	5
OG0008110	0	0	0	5	5
OG0008111	0	0	0	5	5
OG0008112	0	0	0	5	5
OG0008113	0	0	0	5	5
OG0008114	0	0	0	5	5
OG0008115	0	0	0	5	5
OG0008116	0	0	0	5	5
OG0008117	0	0	0	5	5
OG0008118	0	0	0	5	5
OG0008119	0	0	0	5	5
OG0008120	0	0	0	5	5
OG0008121	0	0	0	5	5
OG0008122	0	0	0	5	5
OG0008123	0	0	0	5	5
OG0008124	0	0	0	5	5
OG0008125	0	0	0	5	5
OG0008126	0	0	0	5	5
OG0008127	0	0	0	5	5
OG0008128	0	0	0	5	5
OG0008129	0	0	0	5	5
OG0008130	0	0	0	5	5
OG0008131	0	0	0	5	5
OG0008132	0	0	0	5	5
OG0008133	0	0	0	5	5
OG0008134	0	0	0	5	5
OG0008135	0	0	0	5	5
OG0008136	0	0	0	5	5
OG0008137	0	0	0	5	5
OG0008138	0	0	0	5	5
OG0008139	0	0	0	5	5
OG0008140	0	0	0	5	5
OG0008141	0	0	0	5	5
OG0008142	0	0	0	5	5
OG0008143	0	0	0	5	5
OG0008144	0	0	0	5	5
OG0008145	0	0	0	5	5
OG0008146	0	0	0	5	5
OG0008147	0	0	0	5	5
OG0008148	0	0	0	5	5
OG0008149	0	0	0	5	5
OG0008150	0	0	0	5	5
OG0008151	0	0	0	5	5
OG0008152	0	0	0	5	5
OG0008153	0	0	0	5	5
OG0008154	0	0	0	5	5
OG0008155	0	0	0	5	5
OG0008156	0	0	0	5	5
OG0008157	0	0	0	5	5
OG0008158	0	0	0	5	5
OG0008159	0	0	0	5	5
OG0008160	0	0	0	5	5
OG0008161	0	0	0	5	5
OG0008162	0	0	0	5	5
OG0008163	0	0	0	5	5
OG0008164	0	0	0	5	5
OG0008165	0	0	0	5	5
OG0008166	0	0	0	5	5
OG0008167	0	0	0	5	5
OG0008168	0	0	0	5	5
OG0008169	0	0	0	5	5
OG0008170	0	0	0	5	5
OG0008171	0	0	0	5	5
OG0008172	0	0	0	5	5
OG0008173	0	0	0	5	5
OG0008174	0	0	0	5	5
OG0008175	0	0	0	5	5
OG0008176	0	0	0	5	5
OG0008177	0	0	0	5	5
OG0008178	0	0	0	5	5
OG0008179	0	0	0	5	5
OG0008180	0	0	0	5	5
OG0008181	0	0	0	5	5
OG0008182	0	0	0	5	5
OG0008183	0	0	0	5	5
OG0008184	0	0	0	5	5
OG0008185	0	0	0	5	5
OG0008186	0	0	0	5	5
OG0008187	0	0	0	5	5
OG0008188	0	0	0	5	5
OG0008189	0	0	0	5	5
OG0008190	0	0	0	5	5
OG0008191	0	0	0	5	5
OG0008192	0	0	0	5	5
OG0008193	0	0	0	5	5
OG0008194	0	0	0	5	5
OG0008195	0	0	0	5	5
OG0008196	0	0	0	5	5
OG0008197	0	0	0	5	5
OG0008198	0	0	0	5	5
OG0008199	0	0	0	5	5
OG0008200	0	0	0	5	5
OG0008201	0	0	0	5	5
OG0008202	0	0	0	5	5
OG0008203	0	0	0	5	5
OG0008204	0	0	0	5	5
OG0008205	0	0	0	5	5
OG0008206	0	0	0	5	5
OG0008207	0	0	0	5	5
OG0008208	0	0	0	5	5
OG0008209	0	0	0	5	5
OG0008210	0	0	0	5	5
OG0008211	0	0	0	5	5
OG0008212	0	0	0	5	5
OG0008213	0	0	0	5	5
OG0008214	0	0	0	5	5
OG0008215	0	0	0	5	5
OG0008216	0	0	0	5	5
OG0008217	0	0	0	5	5
OG0008218	0	0	0	5	5
OG0008219	0	0	0	5	5
OG0008220	0	0	0	5	5
OG0008221	0	0	0	5	5
OG0008222	0	0	0	5	5
OG0008223	0	0	0	5	5
OG0008224	0	0	0	5	5
OG0008225	0	0	0	5	5
OG0008226	0	0	0	5	5
OG0008227	0	0	0	5	5
OG0008228	0	0	0	5	5
OG0008229	0	0	0	5	5
OG0008230	0	0	0	5	5
OG0008231	0	0	0	5	5
OG0008232	0	0	0	5	5
OG0008233	0	0	0	5	5
OG0008234	0	0	0	5	5
OG0008235	0	0	0	5	5
OG0008236	0	0	0	5	5
OG0008237	0	0	0	5	5
OG0008238	0	0	0	5	5
OG0008239	0	0	0	5	5
OG0008240	0	0	0	5	5
OG0008241	0	0	0	5	5
OG0008242	0	0	0	5	5
OG0008243	0	0	0	5	5
OG0008244	0	0	0	5	5
OG0008245	4	0	0	0	4
OG0008246	4	0	0	0	4
OG0008247	4	0	0	0	4
OG0008248	4	0	0	0	4
OG0008249	3	1	0	0	4
OG0008250	3	0	0	1	4
OG0008251	4	0	0	0	4
OG0008252	4	0	0	0	4
OG0008253	4	0	0	0	4
OG0008254	2	0	0	2	4
OG0008255	2	0	0	2	4
OG0008256	3	1	0	0	4
OG0008257	3	0	0	1	4
OG0008258	2	0	0	2	4
OG0008259	3	0	0	1	4
OG0008260	3	1	0	0	4
OG0008261	4	0	0	0	4
OG0008262	2	0	1	1	4
OG0008263	3	0	0	1	4
OG0008264	4	0	0	0	4
OG0008265	3	0	0	1	4
OG0008266	3	1	0	0	4
OG0008267	2	0	0	2	4
OG0008268	4	0	0	0	4
OG0008269	4	0	0	0	4
OG0008270	4	0	0	0	4
OG0008271	3	1	0	0	4
OG0008272	1	2	0	1	4
OG0008273	1	3	0	0	4
OG0008274	3	0	0	1	4
OG0008275	4	0	0	0	4
OG0008276	3	0	0	1	4
OG0008277	4	0	0	0	4
OG0008278	4	0	0	0	4
OG0008279	4	0	0	0	4
OG0008280	1	0	0	3	4
OG0008281	4	0	0	0	4
OG0008282	2	0	1	1	4
OG0008283	4	0	0	0	4
OG0008284	3	0	0	1	4
OG0008285	3	0	0	1	4
OG0008286	4	0	0	0	4
OG0008287	1	0	0	3	4
OG0008288	4	0	0	0	4
OG0008289	2	1	0	1	4
OG0008290	3	0	0	1	4
OG0008291	2	0	0	2	4
OG0008292	4	0	0	0	4
OG0008293	4	0	0	0	4
OG0008294	2	1	0	1	4
OG0008295	3	0	0	1	4
OG0008296	4	0	0	0	4
OG0008297	4	0	0	0	4
OG0008298	1	0	0	3	4
OG0008299	2	2	0	0	4
OG0008300	3	0	0	1	4
OG0008301	1	0	0	3	4
OG0008302	4	0	0	0	4
OG0008303	1	1	1	1	4
OG0008304	3	0	0	1	4
OG0008305	3	0	0	1	4
OG0008306	2	1	0	1	4
OG0008307	2	0	0	2	4
OG0008308	4	0	0	0	4
OG0008309	3	1	0	0	4
OG0008310	4	0	0	0	4
OG0008311	3	0	0	1	4
OG0008312	3	0	0	1	4
OG0008313	4	0	0	0	4
OG0008314	4	0	0	0	4
OG0008315	4	0	0	0	4
OG0008316	2	1	0	1	4
OG0008317	3	0	1	0	4
OG0008318	4	0	0	0	4
OG0008319	4	0	0	0	4
OG0008320	4	0	0	0	4
OG0008321	4	0	0	0	4
OG0008322	3	0	0	1	4
OG0008323	2	0	1	1	4
OG0008324	4	0	0	0	4
OG0008325	3	1	0	0	4
OG0008326	4	0	0	0	4
OG0008327	4	0	0	0	4
OG0008328	2	0	0	2	4
OG0008329	4	0	0	0	4
OG0008330	2	0	0	2	4
OG0008331	4	0	0	0	4
OG0008332	4	0	0	0	4
OG0008333	3	0	0	1	4
OG0008334	2	0	0	2	4
OG0008335	2	0	1	1	4
OG0008336	1	1	0	2	4
OG0008337	3	0	0	1	4
OG0008338	2	0	0	2	4
OG0008339	2	0	1	1	4
OG0008340	4	0	0	0	4
OG0008341	1	1	1	1	4
OG0008342	3	0	0	1	4
OG0008343	3	0	0	1	4
OG0008344	3	0	0	1	4
OG0008345	4	0	0	0	4
OG0008346	2	0	0	2	4
OG0008347	3	0	0	1	4
OG0008348	3	0	0	1	4
OG0008349	1	0	0	3	4
OG0008350	2	0	0	2	4
OG0008351	2	1	0	1	4
OG0008352	1	3	0	0	4
OG0008353	4	0	0	0	4
OG0008354	4	0	0	0	4
OG0008355	4	0	0	0	4
OG0008356	3	0	0	1	4
OG0008357	2	1	1	0	4
OG0008358	4	0	0	0	4
OG0008359	2	0	1	1	4
OG0008360	4	0	0	0	4
OG0008361	3	0	0	1	4
OG0008362	2	1	0	1	4
OG0008363	1	0	0	3	4
OG0008364	3	0	0	1	4
OG0008365	4	0	0	0	4
OG0008366	4	0	0	0	4
OG0008367	2	0	0	2	4
OG0008368	2	1	0	1	4
OG0008369	4	0	0	0	4
OG0008370	1	0	0	3	4
OG0008371	4	0	0	0	4
OG0008372	4	0	0	0	4
OG0008373	3	0	1	0	4
OG0008374	1	2	0	1	4
OG0008375	2	1	0	1	4
OG0008376	4	0	0	0	4
OG0008377	2	1	1	0	4
OG0008378	4	0	0	0	4
OG0008379	4	0	0	0	4
OG0008380	4	0	0	0	4
OG0008381	4	0	0	0	4
OG0008382	2	2	0	0	4
OG0008383	3	0	0	1	4
OG0008384	4	0	0	0	4
OG0008385	4	0	0	0	4
OG0008386	4	0	0	0	4
OG0008387	4	0	0	0	4
OG0008388	2	0	0	2	4
OG0008389	4	0	0	0	4
OG0008390	4	0	0	0	4
OG0008391	3	0	0	1	4
OG0008392	2	1	0	1	4
OG0008393	2	0	0	2	4
OG0008394	1	2	0	1	4
OG0008395	4	0	0	0	4
OG0008396	2	1	0	1	4
OG0008397	3	0	0	1	4
OG0008398	4	0	0	0	4
OG0008399	4	0	0	0	4
OG0008400	4	0	0	0	4
OG0008401	4	0	0	0	4
OG0008402	4	0	0	0	4
OG0008403	4	0	0	0	4
OG0008404	4	0	0	0	4
OG0008405	2	0	1	1	4
OG0008406	2	0	0	2	4
OG0008407	3	0	0	1	4
OG0008408	4	0	0	0	4
OG0008409	4	0	0	0	4
OG0008410	2	0	1	1	4
OG0008411	1	0	0	3	4
OG0008412	4	0	0	0	4
OG0008413	3	0	0	1	4
OG0008414	2	0	0	2	4
OG0008415	3	0	0	1	4
OG0008416	4	0	0	0	4
OG0008417	3	0	0	1	4
OG0008418	4	0	0	0	4
OG0008419	2	0	0	2	4
OG0008420	4	0	0	0	4
OG0008421	2	0	1	1	4
OG0008422	2	0	0	2	4
OG0008423	1	0	0	3	4
OG0008424	2	1	0	1	4
OG0008425	3	0	0	1	4
OG0008426	2	0	1	1	4
OG0008427	4	0	0	0	4
OG0008428	2	0	0	2	4
OG0008429	3	0	0	1	4
OG0008430	2	1	0	1	4
OG0008431	4	0	0	0	4
OG0008432	1	0	0	3	4
OG0008433	4	0	0	0	4
OG0008434	2	0	0	2	4
OG0008435	4	0	0	0	4
OG0008436	4	0	0	0	4
OG0008437	3	0	0	1	4
OG0008438	4	0	0	0	4
OG0008439	4	0	0	0	4
OG0008440	4	0	0	0	4
OG0008441	4	0	0	0	4
OG0008442	3	0	0	1	4
OG0008443	2	0	0	2	4
OG0008444	4	0	0	0	4
OG0008445	3	1	0	0	4
OG0008446	4	0	0	0	4
OG0008447	1	3	0	0	4
OG0008448	4	0	0	0	4
OG0008449	3	0	0	1	4
OG0008450	4	0	0	0	4
OG0008451	2	0	1	1	4
OG0008452	2	0	1	1	4
OG0008453	2	1	0	1	4
OG0008454	4	0	0	0	4
OG0008455	4	0	0	0	4
OG0008456	3	0	0	1	4
OG0008457	4	0	0	0	4
OG0008458	1	3	0	0	4
OG0008459	4	0	0	0	4
OG0008460	4	0	0	0	4
OG0008461	2	0	0	2	4
OG0008462	4	0	0	0	4
OG0008463	2	0	1	1	4
OG0008464	4	0	0	0	4
OG0008465	1	1	0	2	4
OG0008466	2	0	1	1	4
OG0008467	1	0	0	3	4
OG0008468	4	0	0	0	4
OG0008469	3	0	0	1	4
OG0008470	4	0	0	0	4
OG0008471	4	0	0	0	4
OG0008472	2	0	1	1	4
OG0008473	2	0	0	2	4
OG0008474	3	0	0	1	4
OG0008475	4	0	0	0	4
OG0008476	3	0	0	1	4
OG0008477	2	0	0	2	4
OG0008478	4	0	0	0	4
OG0008479	4	0	0	0	4
OG0008480	2	1	0	1	4
OG0008481	1	1	1	1	4
OG0008482	4	0	0	0	4
OG0008483	4	0	0	0	4
OG0008484	2	0	1	1	4
OG0008485	2	0	1	1	4
OG0008486	2	0	1	1	4
OG0008487	4	0	0	0	4
OG0008488	2	1	0	1	4
OG0008489	4	0	0	0	4
OG0008490	4	0	0	0	4
OG0008491	4	0	0	0	4
OG0008492	4	0	0	0	4
OG0008493	4	0	0	0	4
OG0008494	2	0	1	1	4
OG0008495	2	0	0	2	4
OG0008496	2	0	0	2	4
OG0008497	4	0	0	0	4
OG0008498	4	0	0	0	4
OG0008499	4	0	0	0	4
OG0008500	2	1	0	1	4
OG0008501	4	0	0	0	4
OG0008502	3	0	0	1	4
OG0008503	2	0	0	2	4
OG0008504	4	0	0	0	4
OG0008505	2	0	0	2	4
OG0008506	1	3	0	0	4
OG0008507	2	1	0	1	4
OG0008508	4	0	0	0	4
OG0008509	4	0	0	0	4
OG0008510	2	1	0	1	4
OG0008511	2	0	0	2	4
OG0008512	2	1	0	1	4
OG0008513	2	0	0	2	4
OG0008514	2	0	0	2	4
OG0008515	4	0	0	0	4
OG0008516	4	0	0	0	4
OG0008517	3	0	0	1	4
OG0008518	3	0	0	1	4
OG0008519	4	0	0	0	4
OG0008520	2	0	0	2	4
OG0008521	4	0	0	0	4
OG0008522	4	0	0	0	4
OG0008523	2	1	0	1	4
OG0008524	1	0	0	3	4
OG0008525	1	2	1	0	4
OG0008526	1	3	0	0	4
OG0008527	3	0	0	1	4
OG0008528	2	1	0	1	4
OG0008529	2	1	0	1	4
OG0008530	2	0	1	1	4
OG0008531	4	0	0	0	4
OG0008532	3	0	0	1	4
OG0008533	4	0	0	0	4
OG0008534	3	0	0	1	4
OG0008535	4	0	0	0	4
OG0008536	1	1	1	1	4
OG0008537	2	0	0	2	4
OG0008538	2	0	0	2	4
OG0008539	2	0	0	2	4
OG0008540	4	0	0	0	4
OG0008541	2	0	1	1	4
OG0008542	4	0	0	0	4
OG0008543	3	0	0	1	4
OG0008544	2	0	0	2	4
OG0008545	2	1	0	1	4
OG0008546	4	0	0	0	4
OG0008547	4	0	0	0	4
OG0008548	3	1	0	0	4
OG0008549	4	0	0	0	4
OG0008550	2	0	1	1	4
OG0008551	2	0	0	2	4
OG0008552	1	0	0	3	4
OG0008553	1	0	0	3	4
OG0008554	2	1	0	1	4
OG0008555	4	0	0	0	4
OG0008556	2	0	1	1	4
OG0008557	2	0	1	1	4
OG0008558	3	0	0	1	4
OG0008559	4	0	0	0	4
OG0008560	1	1	1	1	4
OG0008561	4	0	0	0	4
OG0008562	1	1	0	2	4
OG0008563	1	0	0	3	4
OG0008564	4	0	0	0	4
OG0008565	2	0	0	2	4
OG0008566	3	0	1	0	4
OG0008567	1	0	0	3	4
OG0008568	4	0	0	0	4
OG0008569	2	1	0	1	4
OG0008570	4	0	0	0	4
OG0008571	3	0	0	1	4
OG0008572	4	0	0	0	4
OG0008573	4	0	0	0	4
OG0008574	2	0	0	2	4
OG0008575	2	0	1	1	4
OG0008576	2	1	0	1	4
OG0008577	3	0	0	1	4
OG0008578	3	0	0	1	4
OG0008579	1	0	0	3	4
OG0008580	3	0	0	1	4
OG0008581	4	0	0	0	4
OG0008582	4	0	0	0	4
OG0008583	4	0	0	0	4
OG0008584	3	0	0	1	4
OG0008585	3	0	0	1	4
OG0008586	2	1	0	1	4
OG0008587	2	0	0	2	4
OG0008588	3	0	0	1	4
OG0008589	2	0	1	1	4
OG0008590	3	0	0	1	4
OG0008591	3	0	0	1	4
OG0008592	2	0	0	2	4
OG0008593	3	1	0	0	4
OG0008594	3	0	0	1	4
OG0008595	2	0	1	1	4
OG0008596	3	0	0	1	4
OG0008597	2	1	0	1	4
OG0008598	2	1	0	1	4
OG0008599	2	1	0	1	4
OG0008600	4	0	0	0	4
OG0008601	2	0	1	1	4
OG0008602	4	0	0	0	4
OG0008603	4	0	0	0	4
OG0008604	2	0	1	1	4
OG0008605	2	0	1	1	4
OG0008606	2	0	1	1	4
OG0008607	2	0	0	2	4
OG0008608	3	0	0	1	4
OG0008609	2	0	0	2	4
OG0008610	4	0	0	0	4
OG0008611	3	0	0	1	4
OG0008612	2	1	0	1	4
OG0008613	4	0	0	0	4
OG0008614	2	1	0	1	4
OG0008615	4	0	0	0	4
OG0008616	2	0	1	1	4
OG0008617	1	2	0	1	4
OG0008618	4	0	0	0	4
OG0008619	2	1	1	0	4
OG0008620	2	0	1	1	4
OG0008621	1	0	0	3	4
OG0008622	3	0	0	1	4
OG0008623	4	0	0	0	4
OG0008624	3	0	0	1	4
OG0008625	3	0	0	1	4
OG0008626	4	0	0	0	4
OG0008627	3	0	0	1	4
OG0008628	3	0	0	1	4
OG0008629	4	0	0	0	4
OG0008630	4	0	0	0	4
OG0008631	2	0	1	1	4
OG0008632	4	0	0	0	4
OG0008633	4	0	0	0	4
OG0008634	3	0	0	1	4
OG0008635	4	0	0	0	4
OG0008636	4	0	0	0	4
OG0008637	1	0	0	3	4
OG0008638	2	0	0	2	4
OG0008639	4	0	0	0	4
OG0008640	2	0	0	2	4
OG0008641	2	0	0	2	4
OG0008642	2	0	1	1	4
OG0008643	3	0	0	1	4
OG0008644	2	0	0	2	4
OG0008645	3	0	0	1	4
OG0008646	2	0	0	2	4
OG0008647	2	0	0	2	4
OG0008648	4	0	0	0	4
OG0008649	4	0	0	0	4
OG0008650	3	0	0	1	4
OG0008651	3	1	0	0	4
OG0008652	4	0	0	0	4
OG0008653	1	0	0	3	4
OG0008654	4	0	0	0	4
OG0008655	4	0	0	0	4
OG0008656	3	0	0	1	4
OG0008657	4	0	0	0	4
OG0008658	4	0	0	0	4
OG0008659	1	2	0	1	4
OG0008660	2	0	0	2	4
OG0008661	4	0	0	0	4
OG0008662	4	0	0	0	4
OG0008663	2	2	0	0	4
OG0008664	2	0	0	2	4
OG0008665	4	0	0	0	4
OG0008666	2	0	0	2	4
OG0008667	3	1	0	0	4
OG0008668	4	0	0	0	4
OG0008669	4	0	0	0	4
OG0008670	2	0	1	1	4
OG0008671	2	1	0	1	4
OG0008672	1	0	0	3	4
OG0008673	4	0	0	0	4
OG0008674	4	0	0	0	4
OG0008675	4	0	0	0	4
OG0008676	3	0	0	1	4
OG0008677	2	0	0	2	4
OG0008678	2	0	0	2	4
OG0008679	4	0	0	0	4
OG0008680	4	0	0	0	4
OG0008681	4	0	0	0	4
OG0008682	2	0	0	2	4
OG0008683	4	0	0	0	4
OG0008684	1	0	1	2	4
OG0008685	2	0	0	2	4
OG0008686	1	0	0	3	4
OG0008687	2	1	0	1	4
OG0008688	3	0	0	1	4
OG0008689	1	0	0	3	4
OG0008690	1	0	0	3	4
OG0008691	2	0	0	2	4
OG0008692	4	0	0	0	4
OG0008693	3	0	0	1	4
OG0008694	4	0	0	0	4
OG0008695	3	0	0	1	4
OG0008696	4	0	0	0	4
OG0008697	4	0	0	0	4
OG0008698	1	0	0	3	4
OG0008699	4	0	0	0	4
OG0008700	2	0	1	1	4
OG0008701	4	0	0	0	4
OG0008702	2	0	0	2	4
OG0008703	3	0	0	1	4
OG0008704	2	0	0	2	4
OG0008705	1	0	0	3	4
OG0008706	3	0	0	1	4
OG0008707	3	0	0	1	4
OG0008708	4	0	0	0	4
OG0008709	4	0	0	0	4
OG0008710	3	0	0	1	4
OG0008711	1	0	0	3	4
OG0008712	4	0	0	0	4
OG0008713	4	0	0	0	4
OG0008714	1	0	0	3	4
OG0008715	4	0	0	0	4
OG0008716	4	0	0	0	4
OG0008717	2	1	0	1	4
OG0008718	2	0	0	2	4
OG0008719	2	0	1	1	4
OG0008720	3	0	0	1	4
OG0008721	2	0	1	1	4
OG0008722	4	0	0	0	4
OG0008723	1	0	0	3	4
OG0008724	4	0	0	0	4
OG0008725	2	1	0	1	4
OG0008726	2	1	0	1	4
OG0008727	2	0	0	2	4
OG0008728	2	0	1	1	4
OG0008729	3	0	0	1	4
OG0008730	3	0	0	1	4
OG0008731	3	0	0	1	4
OG0008732	1	0	0	3	4
OG0008733	2	0	0	2	4
OG0008734	3	0	0	1	4
OG0008735	4	0	0	0	4
OG0008736	4	0	0	0	4
OG0008737	4	0	0	0	4
OG0008738	3	0	0	1	4
OG0008739	3	0	0	1	4
OG0008740	3	0	0	1	4
OG0008741	3	0	0	1	4
OG0008742	3	0	0	1	4
OG0008743	3	1	0	0	4
OG0008744	4	0	0	0	4
OG0008745	2	0	0	2	4
OG0008746	1	0	0	3	4
OG0008747	2	0	0	2	4
OG0008748	1	0	0	3	4
OG0008749	3	0	0	1	4
OG0008750	4	0	0	0	4
OG0008751	1	1	1	1	4
OG0008752	2	1	0	1	4
OG0008753	4	0	0	0	4
OG0008754	2	2	0	0	4
OG0008755	1	0	0	3	4
OG0008756	4	0	0	0	4
OG0008757	1	1	1	1	4
OG0008758	3	1	0	0	4
OG0008759	4	0	0	0	4
OG0008760	4	0	0	0	4
OG0008761	2	1	0	1	4
OG0008762	1	1	1	1	4
OG0008763	1	1	1	1	4
OG0008764	2	0	0	2	4
OG0008765	3	0	0	1	4
OG0008766	4	0	0	0	4
OG0008767	3	0	0	1	4
OG0008768	1	1	1	1	4
OG0008769	3	0	0	1	4
OG0008770	1	1	1	1	4
OG0008771	4	0	0	0	4
OG0008772	2	2	0	0	4
OG0008773	3	0	0	1	4
OG0008774	1	1	0	2	4
OG0008775	4	0	0	0	4
OG0008776	1	0	0	3	4
OG0008777	4	0	0	0	4
OG0008778	1	0	0	3	4
OG0008779	1	1	1	1	4
OG0008780	4	0	0	0	4
OG0008781	1	0	1	2	4
OG0008782	1	0	1	2	4
OG0008783	1	0	0	3	4
OG0008784	4	0	0	0	4
OG0008785	2	2	0	0	4
OG0008786	3	0	0	1	4
OG0008787	1	1	1	1	4
OG0008788	4	0	0	0	4
OG0008789	3	0	0	1	4
OG0008790	3	0	0	1	4
OG0008791	4	0	0	0	4
OG0008792	3	0	0	1	4
OG0008793	1	1	1	1	4
OG0008794	1	1	1	1	4
OG0008795	2	1	0	1	4
OG0008796	1	2	0	1	4
OG0008797	1	1	1	1	4
OG0008798	2	1	0	1	4
OG0008799	1	0	0	3	4
OG0008800	4	0	0	0	4
OG0008801	2	0	1	1	4
OG0008802	1	1	0	2	4
OG0008803	2	0	1	1	4
OG0008804	2	0	0	2	4
OG0008805	4	0	0	0	4
OG0008806	4	0	0	0	4
OG0008807	4	0	0	0	4
OG0008808	4	0	0	0	4
OG0008809	1	0	0	3	4
OG0008810	4	0	0	0	4
OG0008811	1	1	1	1	4
OG0008812	1	0	0	3	4
OG0008813	1	0	0	3	4
OG0008814	1	1	1	1	4
OG0008815	3	0	0	1	4
OG0008816	1	1	1	1	4
OG0008817	2	1	0	1	4
OG0008818	1	1	1	1	4
OG0008819	2	1	0	1	4
OG0008820	1	0	0	3	4
OG0008821	4	0	0	0	4
OG0008822	3	0	0	1	4
OG0008823	3	0	0	1	4
OG0008824	2	0	0	2	4
OG0008825	4	0	0	0	4
OG0008826	4	0	0	0	4
OG0008827	2	0	0	2	4
OG0008828	1	0	0	3	4
OG0008829	2	1	0	1	4
OG0008830	4	0	0	0	4
OG0008831	4	0	0	0	4
OG0008832	1	0	0	3	4
OG0008833	1	1	1	1	4
OG0008834	1	1	1	1	4
OG0008835	2	0	0	2	4
OG0008836	1	2	0	1	4
OG0008837	1	1	1	1	4
OG0008838	2	0	0	2	4
OG0008839	3	0	1	0	4
OG0008840	4	0	0	0	4
OG0008841	1	0	0	3	4
OG0008842	1	1	1	1	4
OG0008843	4	0	0	0	4
OG0008844	2	1	0	1	4
OG0008845	4	0	0	0	4
OG0008846	4	0	0	0	4
OG0008847	1	0	0	3	4
OG0008848	1	0	0	3	4
OG0008849	1	0	0	3	4
OG0008850	4	0	0	0	4
OG0008851	1	1	0	2	4
OG0008852	2	0	0	2	4
OG0008853	3	0	0	1	4
OG0008854	1	1	1	1	4
OG0008855	1	1	1	1	4
OG0008856	1	0	0	3	4
OG0008857	3	0	0	1	4
OG0008858	1	2	0	1	4
OG0008859	4	0	0	0	4
OG0008860	4	0	0	0	4
OG0008861	1	2	0	1	4
OG0008862	1	2	0	1	4
OG0008863	4	0	0	0	4
OG0008864	2	0	0	2	4
OG0008865	3	0	0	1	4
OG0008866	1	1	1	1	4
OG0008867	4	0	0	0	4
OG0008868	4	0	0	0	4
OG0008869	1	2	0	1	4
OG0008870	1	1	1	1	4
OG0008871	1	0	0	3	4
OG0008872	1	1	1	1	4
OG0008873	2	1	0	1	4
OG0008874	4	0	0	0	4
OG0008875	4	0	0	0	4
OG0008876	1	1	1	1	4
OG0008877	4	0	0	0	4
OG0008878	3	0	0	1	4
OG0008879	3	1	0	0	4
OG0008880	4	0	0	0	4
OG0008881	1	1	1	1	4
OG0008882	1	1	1	1	4
OG0008883	1	0	0	3	4
OG0008884	1	1	1	1	4
OG0008885	2	1	0	1	4
OG0008886	3	0	0	1	4
OG0008887	1	0	0	3	4
OG0008888	4	0	0	0	4
OG0008889	2	0	1	1	4
OG0008890	1	1	1	1	4
OG0008891	4	0	0	0	4
OG0008892	4	0	0	0	4
OG0008893	2	0	0	2	4
OG0008894	3	0	0	1	4
OG0008895	2	1	0	1	4
OG0008896	1	0	1	2	4
OG0008897	1	1	1	1	4
OG0008898	3	0	0	1	4
OG0008899	2	0	0	2	4
OG0008900	3	0	0	1	4
OG0008901	1	2	0	1	4
OG0008902	1	1	1	1	4
OG0008903	4	0	0	0	4
OG0008904	4	0	0	0	4
OG0008905	4	0	0	0	4
OG0008906	3	0	0	1	4
OG0008907	1	0	0	3	4
OG0008908	1	1	1	1	4
OG0008909	1	1	1	1	4
OG0008910	4	0	0	0	4
OG0008911	2	0	0	2	4
OG0008912	1	1	1	1	4
OG0008913	2	0	0	2	4
OG0008914	2	0	0	2	4
OG0008915	2	0	0	2	4
OG0008916	1	1	1	1	4
OG0008917	1	1	1	1	4
OG0008918	1	2	1	0	4
OG0008919	1	1	1	1	4
OG0008920	1	1	1	1	4
OG0008921	1	1	1	1	4
OG0008922	1	0	0	3	4
OG0008923	1	0	2	1	4
OG0008924	4	0	0	0	4
OG0008925	2	0	0	2	4
OG0008926	1	1	1	1	4
OG0008927	1	1	1	1	4
OG0008928	1	0	0	3	4
OG0008929	1	1	0	2	4
OG0008930	1	1	1	1	4
OG0008931	1	1	1	1	4
OG0008932	1	0	0	3	4
OG0008933	1	1	1	1	4
OG0008934	1	1	1	1	4
OG0008935	1	0	0	3	4
OG0008936	2	0	1	1	4
OG0008937	1	0	0	3	4
OG0008938	1	1	0	2	4
OG0008939	1	0	2	1	4
OG0008940	1	0	0	3	4
OG0008941	1	1	1	1	4
OG0008942	1	1	1	1	4
OG0008943	1	1	1	1	4
OG0008944	4	0	0	0	4
OG0008945	1	2	0	1	4
OG0008946	1	1	1	1	4
OG0008947	2	0	0	2	4
OG0008948	4	0	0	0	4
OG0008949	1	0	0	3	4
OG0008950	1	1	1	1	4
OG0008951	1	0	0	3	4
OG0008952	3	0	0	1	4
OG0008953	4	0	0	0	4
OG0008954	1	1	1	1	4
OG0008955	1	1	1	1	4
OG0008956	2	0	0	2	4
OG0008957	3	0	0	1	4
OG0008958	1	1	1	1	4
OG0008959	1	1	1	1	4
OG0008960	1	0	0	3	4
OG0008961	2	0	0	2	4
OG0008962	1	1	1	1	4
OG0008963	1	1	0	2	4
OG0008964	1	1	1	1	4
OG0008965	1	1	1	1	4
OG0008966	1	1	1	1	4
OG0008967	1	0	1	2	4
OG0008968	2	0	0	2	4
OG0008969	2	0	0	2	4
OG0008970	1	1	1	1	4
OG0008971	1	1	1	1	4
OG0008972	1	1	1	1	4
OG0008973	2	0	0	2	4
OG0008974	1	1	0	2	4
OG0008975	1	0	2	1	4
OG0008976	1	1	1	1	4
OG0008977	1	1	1	1	4
OG0008978	1	0	1	2	4
OG0008979	1	0	0	3	4
OG0008980	1	1	1	1	4
OG0008981	1	1	1	1	4
OG0008982	1	1	1	1	4
OG0008983	1	1	1	1	4
OG0008984	1	1	1	1	4
OG0008985	2	0	0	2	4
OG0008986	1	0	1	2	4
OG0008987	1	0	1	2	4
OG0008988	1	1	0	2	4
OG0008989	3	0	0	1	4
OG0008990	1	1	1	1	4
OG0008991	1	1	1	1	4
OG0008992	1	1	1	1	4
OG0008993	1	1	1	1	4
OG0008994	1	1	1	1	4
OG0008995	1	0	0	3	4
OG0008996	1	1	1	1	4
OG0008997	2	0	0	2	4
OG0008998	2	0	0	2	4
OG0008999	3	0	0	1	4
OG0009000	2	0	0	2	4
OG0009001	1	1	0	2	4
OG0009002	2	0	0	2	4
OG0009003	1	1	1	1	4
OG0009004	1	1	1	1	4
OG0009005	1	3	0	0	4
OG0009006	1	1	1	1	4
OG0009007	2	1	0	1	4
OG0009008	1	1	1	1	4
OG0009009	1	1	1	1	4
OG0009010	2	1	0	1	4
OG0009011	1	1	1	1	4
OG0009012	1	1	0	2	4
OG0009013	1	1	1	1	4
OG0009014	2	0	0	2	4
OG0009015	1	1	1	1	4
OG0009016	1	1	1	1	4
OG0009017	1	1	1	1	4
OG0009018	1	1	1	1	4
OG0009019	4	0	0	0	4
OG0009020	1	1	1	1	4
OG0009021	1	1	1	1	4
OG0009022	1	1	1	1	4
OG0009023	1	2	0	1	4
OG0009024	1	1	1	1	4
OG0009025	1	1	1	1	4
OG0009026	1	1	1	1	4
OG0009027	1	1	1	1	4
OG0009028	4	0	0	0	4
OG0009029	1	1	1	1	4
OG0009030	1	1	1	1	4
OG0009031	1	1	1	1	4
OG0009032	1	1	1	1	4
OG0009033	1	1	1	1	4
OG0009034	1	3	0	0	4
OG0009035	1	1	1	1	4
OG0009036	1	1	1	1	4
OG0009037	1	2	0	1	4
OG0009038	1	1	1	1	4
OG0009039	2	0	1	1	4
OG0009040	1	1	1	1	4
OG0009041	1	1	1	1	4
OG0009042	1	0	0	3	4
OG0009043	3	1	0	0	4
OG0009044	1	0	0	3	4
OG0009045	1	1	1	1	4
OG0009046	3	0	0	1	4
OG0009047	2	1	0	1	4
OG0009048	1	1	1	1	4
OG0009049	1	1	1	1	4
OG0009050	1	1	1	1	4
OG0009051	1	1	1	1	4
OG0009052	2	0	0	2	4
OG0009053	1	1	1	1	4
OG0009054	4	0	0	0	4
OG0009055	2	0	0	2	4
OG0009056	4	0	0	0	4
OG0009057	1	1	1	1	4
OG0009058	4	0	0	0	4
OG0009059	1	1	1	1	4
OG0009060	1	1	1	1	4
OG0009061	1	1	1	1	4
OG0009062	1	1	1	1	4
OG0009063	1	1	1	1	4
OG0009064	1	1	1	1	4
OG0009065	1	1	1	1	4
OG0009066	1	1	1	1	4
OG0009067	1	1	1	1	4
OG0009068	1	1	1	1	4
OG0009069	1	1	1	1	4
OG0009070	4	0	0	0	4
OG0009071	4	0	0	0	4
OG0009072	1	1	1	1	4
OG0009073	4	0	0	0	4
OG0009074	1	1	1	1	4
OG0009075	1	1	1	1	4
OG0009076	1	1	1	1	4
OG0009077	1	1	1	1	4
OG0009078	1	2	0	1	4
OG0009079	1	1	1	1	4
OG0009080	2	0	0	2	4
OG0009081	4	0	0	0	4
OG0009082	1	1	1	1	4
OG0009083	1	1	1	1	4
OG0009084	1	1	1	1	4
OG0009085	1	1	1	1	4
OG0009086	1	1	1	1	4
OG0009087	3	1	0	0	4
OG0009088	1	1	1	1	4
OG0009089	1	1	1	1	4
OG0009090	3	0	0	1	4
OG0009091	1	1	1	1	4
OG0009092	1	1	1	1	4
OG0009093	1	1	1	1	4
OG0009094	1	1	1	1	4
OG0009095	1	1	1	1	4
OG0009096	1	1	1	1	4
OG0009097	1	1	1	1	4
OG0009098	1	1	1	1	4
OG0009099	1	1	1	1	4
OG0009100	1	1	1	1	4
OG0009101	1	0	1	2	4
OG0009102	1	1	1	1	4
OG0009103	1	1	1	1	4
OG0009104	1	1	1	1	4
OG0009105	4	0	0	0	4
OG0009106	1	1	1	1	4
OG0009107	4	0	0	0	4
OG0009108	1	1	1	1	4
OG0009109	1	1	1	1	4
OG0009110	1	1	1	1	4
OG0009111	1	1	1	1	4
OG0009112	1	1	1	1	4
OG0009113	3	0	0	1	4
OG0009114	4	0	0	0	4
OG0009115	1	2	1	0	4
OG0009116	1	1	1	1	4
OG0009117	1	1	1	1	4
OG0009118	1	1	1	1	4
OG0009119	1	1	1	1	4
OG0009120	1	1	1	1	4
OG0009121	1	1	1	1	4
OG0009122	1	2	0	1	4
OG0009123	1	1	1	1	4
OG0009124	2	0	0	2	4
OG0009125	1	1	1	1	4
OG0009126	2	0	0	2	4
OG0009127	1	0	2	1	4
OG0009128	1	2	0	1	4
OG0009129	1	1	1	1	4
OG0009130	1	1	1	1	4
OG0009131	1	1	1	1	4
OG0009132	1	1	1	1	4
OG0009133	1	1	0	2	4
OG0009134	1	1	1	1	4
OG0009135	1	1	0	2	4
OG0009136	1	1	1	1	4
OG0009137	1	1	1	1	4
OG0009138	1	2	0	1	4
OG0009139	1	0	0	3	4
OG0009140	3	0	0	1	4
OG0009141	2	0	1	1	4
OG0009142	1	0	0	3	4
OG0009143	1	1	1	1	4
OG0009144	1	1	1	1	4
OG0009145	1	1	1	1	4
OG0009146	1	1	1	1	4
OG0009147	1	2	0	1	4
OG0009148	1	0	0	3	4
OG0009149	1	1	1	1	4
OG0009150	1	2	0	1	4
OG0009151	1	1	0	2	4
OG0009152	1	0	0	3	4
OG0009153	1	1	1	1	4
OG0009154	1	1	1	1	4
OG0009155	1	1	1	1	4
OG0009156	1	1	1	1	4
OG0009157	1	1	1	1	4
OG0009158	1	1	1	1	4
OG0009159	1	1	1	1	4
OG0009160	1	1	1	1	4
OG0009161	3	0	0	1	4
OG0009162	3	0	0	1	4
OG0009163	1	1	1	1	4
OG0009164	1	1	1	1	4
OG0009165	1	1	1	1	4
OG0009166	1	1	1	1	4
OG0009167	1	1	1	1	4
OG0009168	1	1	1	1	4
OG0009169	1	0	2	1	4
OG0009170	2	0	0	2	4
OG0009171	1	0	1	2	4
OG0009172	3	0	0	1	4
OG0009173	1	1	1	1	4
OG0009174	2	1	0	1	4
OG0009175	1	1	1	1	4
OG0009176	1	1	1	1	4
OG0009177	1	1	1	1	4
OG0009178	1	1	1	1	4
OG0009179	1	1	1	1	4
OG0009180	1	1	1	1	4
OG0009181	1	1	1	1	4
OG0009182	1	1	1	1	4
OG0009183	1	1	1	1	4
OG0009184	1	1	1	1	4
OG0009185	1	0	1	2	4
OG0009186	1	0	0	3	4
OG0009187	1	1	1	1	4
OG0009188	1	2	0	1	4
OG0009189	1	1	0	2	4
OG0009190	1	1	0	2	4
OG0009191	1	1	1	1	4
OG0009192	1	1	1	1	4
OG0009193	2	0	0	2	4
OG0009194	1	0	1	2	4
OG0009195	1	2	1	0	4
OG0009196	1	0	1	2	4
OG0009197	1	0	0	3	4
OG0009198	4	0	0	0	4
OG0009199	1	1	1	1	4
OG0009200	1	1	1	1	4
OG0009201	1	1	1	1	4
OG0009202	2	0	0	2	4
OG0009203	1	1	1	1	4
OG0009204	2	1	0	1	4
OG0009205	1	0	2	1	4
OG0009206	1	1	1	1	4
OG0009207	2	1	0	1	4
OG0009208	2	0	0	2	4
OG0009209	3	0	0	1	4
OG0009210	1	1	0	2	4
OG0009211	1	2	0	1	4
OG0009212	1	1	1	1	4
OG0009213	1	1	1	1	4
OG0009214	1	1	1	1	4
OG0009215	1	1	0	2	4
OG0009216	1	1	1	1	4
OG0009217	1	1	1	1	4
OG0009218	1	1	1	1	4
OG0009219	1	1	1	1	4
OG0009220	1	1	1	1	4
OG0009221	1	0	1	2	4
OG0009222	2	0	0	2	4
OG0009223	1	1	0	2	4
OG0009224	1	1	1	1	4
OG0009225	1	1	1	1	4
OG0009226	1	1	1	1	4
OG0009227	4	0	0	0	4
OG0009228	1	2	0	1	4
OG0009229	1	0	2	1	4
OG0009230	3	0	0	1	4
OG0009231	1	0	0	3	4
OG0009232	1	0	0	3	4
OG0009233	1	0	0	3	4
OG0009234	1	0	1	2	4
OG0009235	1	1	1	1	4
OG0009236	1	1	1	1	4
OG0009237	2	0	0	2	4
OG0009238	1	0	1	2	4
OG0009239	1	1	1	1	4
OG0009240	1	1	1	1	4
OG0009241	4	0	0	0	4
OG0009242	4	0	0	0	4
OG0009243	1	1	1	1	4
OG0009244	1	1	1	1	4
OG0009245	1	1	1	1	4
OG0009246	1	0	0	3	4
OG0009247	1	1	1	1	4
OG0009248	1	1	0	2	4
OG0009249	1	0	2	1	4
OG0009250	1	1	1	1	4
OG0009251	1	1	1	1	4
OG0009252	1	3	0	0	4
OG0009253	1	1	1	1	4
OG0009254	1	1	1	1	4
OG0009255	4	0	0	0	4
OG0009256	1	1	1	1	4
OG0009257	1	1	0	2	4
OG0009258	1	1	1	1	4
OG0009259	1	1	1	1	4
OG0009260	1	1	1	1	4
OG0009261	1	0	1	2	4
OG0009262	1	0	2	1	4
OG0009263	1	1	1	1	4
OG0009264	1	1	1	1	4
OG0009265	1	1	1	1	4
OG0009266	1	2	0	1	4
OG0009267	1	1	1	1	4
OG0009268	1	2	0	1	4
OG0009269	1	0	0	3	4
OG0009270	1	1	1	1	4
OG0009271	1	1	1	1	4
OG0009272	1	2	0	1	4
OG0009273	1	1	1	1	4
OG0009274	1	1	1	1	4
OG0009275	1	1	1	1	4
OG0009276	1	0	0	3	4
OG0009277	1	1	0	2	4
OG0009278	3	0	0	1	4
OG0009279	1	1	1	1	4
OG0009280	1	1	1	1	4
OG0009281	1	1	1	1	4
OG0009282	1	1	0	2	4
OG0009283	1	1	0	2	4
OG0009284	3	0	0	1	4
OG0009285	1	1	1	1	4
OG0009286	1	1	1	1	4
OG0009287	3	0	0	1	4
OG0009288	1	1	1	1	4
OG0009289	1	1	1	1	4
OG0009290	2	0	0	2	4
OG0009291	1	2	0	1	4
OG0009292	1	1	1	1	4
OG0009293	1	1	1	1	4
OG0009294	1	1	1	1	4
OG0009295	1	1	1	1	4
OG0009296	1	0	1	2	4
OG0009297	1	1	0	2	4
OG0009298	1	2	0	1	4
OG0009299	1	0	0	3	4
OG0009300	1	1	1	1	4
OG0009301	1	1	1	1	4
OG0009302	1	0	2	1	4
OG0009303	2	0	0	2	4
OG0009304	1	1	0	2	4
OG0009305	1	1	1	1	4
OG0009306	1	1	1	1	4
OG0009307	1	1	0	2	4
OG0009308	1	1	1	1	4
OG0009309	1	1	1	1	4
OG0009310	1	1	0	2	4
OG0009311	1	1	1	1	4
OG0009312	1	1	1	1	4
OG0009313	1	0	0	3	4
OG0009314	1	1	1	1	4
OG0009315	1	1	1	1	4
OG0009316	1	1	1	1	4
OG0009317	1	0	1	2	4
OG0009318	1	1	0	2	4
OG0009319	1	1	1	1	4
OG0009320	1	0	2	1	4
OG0009321	1	1	1	1	4
OG0009322	1	1	1	1	4
OG0009323	1	1	1	1	4
OG0009324	1	1	1	1	4
OG0009325	1	1	1	1	4
OG0009326	1	1	1	1	4
OG0009327	1	1	0	2	4
OG0009328	1	0	2	1	4
OG0009329	1	2	0	1	4
OG0009330	4	0	0	0	4
OG0009331	1	1	1	1	4
OG0009332	1	1	1	1	4
OG0009333	1	0	2	1	4
OG0009334	1	1	1	1	4
OG0009335	1	1	1	1	4
OG0009336	2	1	1	0	4
OG0009337	1	0	0	3	4
OG0009338	1	1	1	1	4
OG0009339	1	1	1	1	4
OG0009340	1	1	1	1	4
OG0009341	1	1	1	1	4
OG0009342	1	1	1	1	4
OG0009343	1	1	1	1	4
OG0009344	1	1	1	1	4
OG0009345	1	1	1	1	4
OG0009346	1	1	1	1	4
OG0009347	1	1	1	1	4
OG0009348	1	1	1	1	4
OG0009349	2	1	0	1	4
OG0009350	1	0	2	1	4
OG0009351	1	1	0	2	4
OG0009352	1	1	1	1	4
OG0009353	1	2	0	1	4
OG0009354	1	1	1	1	4
OG0009355	1	1	1	1	4
OG0009356	1	1	1	1	4
OG0009357	1	2	1	0	4
OG0009358	1	1	1	1	4
OG0009359	1	0	2	1	4
OG0009360	1	1	1	1	4
OG0009361	1	1	1	1	4
OG0009362	1	1	1	1	4
OG0009363	1	1	1	1	4
OG0009364	1	1	1	1	4
OG0009365	1	1	1	1	4
OG0009366	1	1	1	1	4
OG0009367	1	1	1	1	4
OG0009368	1	1	1	1	4
OG0009369	1	0	2	1	4
OG0009370	2	0	1	1	4
OG0009371	1	1	1	1	4
OG0009372	1	1	1	1	4
OG0009373	1	1	1	1	4
OG0009374	1	1	1	1	4
OG0009375	1	1	1	1	4
OG0009376	1	1	1	1	4
OG0009377	1	1	1	1	4
OG0009378	1	1	1	1	4
OG0009379	1	1	1	1	4
OG0009380	1	1	1	1	4
OG0009381	1	1	1	1	4
OG0009382	1	1	1	1	4
OG0009383	1	1	1	1	4
OG0009384	1	0	2	1	4
OG0009385	1	0	1	2	4
OG0009386	1	1	1	1	4
OG0009387	1	0	2	1	4
OG0009388	1	1	1	1	4
OG0009389	1	1	1	1	4
OG0009390	1	1	1	1	4
OG0009391	1	0	2	1	4
OG0009392	2	1	0	1	4
OG0009393	1	1	1	1	4
OG0009394	1	1	1	1	4
OG0009395	1	0	0	3	4
OG0009396	1	0	2	1	4
OG0009397	1	1	1	1	4
OG0009398	1	1	1	1	4
OG0009399	1	1	1	1	4
OG0009400	1	0	0	3	4
OG0009401	1	0	0	3	4
OG0009402	3	0	0	1	4
OG0009403	1	1	1	1	4
OG0009404	1	1	1	1	4
OG0009405	1	1	1	1	4
OG0009406	3	0	0	1	4
OG0009407	1	0	1	2	4
OG0009408	1	1	1	1	4
OG0009409	1	1	1	1	4
OG0009410	1	1	1	1	4
OG0009411	1	1	1	1	4
OG0009412	4	0	0	0	4
OG0009413	2	1	0	1	4
OG0009414	1	1	1	1	4
OG0009415	1	1	1	1	4
OG0009416	1	1	1	1	4
OG0009417	1	0	0	3	4
OG0009418	1	2	0	1	4
OG0009419	1	1	1	1	4
OG0009420	1	1	1	1	4
OG0009421	1	1	1	1	4
OG0009422	1	1	1	1	4
OG0009423	1	1	1	1	4
OG0009424	1	1	1	1	4
OG0009425	1	1	1	1	4
OG0009426	1	1	1	1	4
OG0009427	1	1	1	1	4
OG0009428	1	1	1	1	4
OG0009429	1	1	1	1	4
OG0009430	1	0	1	2	4
OG0009431	1	1	1	1	4
OG0009432	1	1	1	1	4
OG0009433	1	1	1	1	4
OG0009434	1	2	0	1	4
OG0009435	1	1	1	1	4
OG0009436	1	0	0	3	4
OG0009437	1	1	1	1	4
OG0009438	1	1	1	1	4
OG0009439	1	1	1	1	4
OG0009440	1	1	1	1	4
OG0009441	1	1	1	1	4
OG0009442	1	2	0	1	4
OG0009443	1	1	1	1	4
OG0009444	1	0	2	1	4
OG0009445	1	0	0	3	4
OG0009446	1	1	1	1	4
OG0009447	1	1	1	1	4
OG0009448	3	0	0	1	4
OG0009449	1	1	1	1	4
OG0009450	1	0	2	1	4
OG0009451	1	1	1	1	4
OG0009452	1	1	1	1	4
OG0009453	1	1	1	1	4
OG0009454	1	1	1	1	4
OG0009455	1	1	1	1	4
OG0009456	1	1	1	1	4
OG0009457	1	1	1	1	4
OG0009458	1	1	1	1	4
OG0009459	1	1	1	1	4
OG0009460	1	1	1	1	4
OG0009461	1	1	1	1	4
OG0009462	1	1	1	1	4
OG0009463	2	1	0	1	4
OG0009464	1	1	1	1	4
OG0009465	1	0	0	3	4
OG0009466	4	0	0	0	4
OG0009467	1	1	1	1	4
OG0009468	1	1	1	1	4
OG0009469	1	1	1	1	4
OG0009470	1	1	1	1	4
OG0009471	1	1	1	1	4
OG0009472	1	1	1	1	4
OG0009473	1	1	1	1	4
OG0009474	1	1	1	1	4
OG0009475	1	1	1	1	4
OG0009476	1	0	2	1	4
OG0009477	1	1	1	1	4
OG0009478	1	1	1	1	4
OG0009479	3	0	0	1	4
OG0009480	1	1	1	1	4
OG0009481	1	1	1	1	4
OG0009482	1	0	0	3	4
OG0009483	1	1	1	1	4
OG0009484	1	1	1	1	4
OG0009485	1	0	2	1	4
OG0009486	1	1	1	1	4
OG0009487	1	1	1	1	4
OG0009488	1	1	1	1	4
OG0009489	1	1	1	1	4
OG0009490	1	1	1	1	4
OG0009491	1	0	1	2	4
OG0009492	1	2	0	1	4
OG0009493	1	1	1	1	4
OG0009494	1	1	1	1	4
OG0009495	1	1	1	1	4
OG0009496	4	0	0	0	4
OG0009497	2	0	0	2	4
OG0009498	1	1	1	1	4
OG0009499	1	1	1	1	4
OG0009500	1	1	1	1	4
OG0009501	1	1	1	1	4
OG0009502	1	2	0	1	4
OG0009503	1	1	1	1	4
OG0009504	1	1	1	1	4
OG0009505	1	1	1	1	4
OG0009506	1	1	1	1	4
OG0009507	1	1	1	1	4
OG0009508	1	1	1	1	4
OG0009509	1	1	1	1	4
OG0009510	1	1	1	1	4
OG0009511	1	1	1	1	4
OG0009512	1	0	2	1	4
OG0009513	1	1	1	1	4
OG0009514	2	1	0	1	4
OG0009515	1	1	1	1	4
OG0009516	1	1	1	1	4
OG0009517	1	1	1	1	4
OG0009518	1	1	1	1	4
OG0009519	1	1	1	1	4
OG0009520	1	0	0	3	4
OG0009521	1	1	1	1	4
OG0009522	1	1	1	1	4
OG0009523	1	1	1	1	4
OG0009524	1	1	1	1	4
OG0009525	1	1	1	1	4
OG0009526	1	2	0	1	4
OG0009527	1	1	1	1	4
OG0009528	1	1	1	1	4
OG0009529	1	1	1	1	4
OG0009530	1	1	1	1	4
OG0009531	1	1	1	1	4
OG0009532	1	1	1	1	4
OG0009533	2	0	0	2	4
OG0009534	1	1	1	1	4
OG0009535	1	1	1	1	4
OG0009536	1	1	1	1	4
OG0009537	1	1	1	1	4
OG0009538	1	1	1	1	4
OG0009539	1	1	1	1	4
OG0009540	1	0	0	3	4
OG0009541	1	1	1	1	4
OG0009542	1	1	1	1	4
OG0009543	1	1	1	1	4
OG0009544	1	1	1	1	4
OG0009545	1	1	1	1	4
OG0009546	1	1	1	1	4
OG0009547	1	2	0	1	4
OG0009548	1	1	1	1	4
OG0009549	2	0	0	2	4
OG0009550	2	0	0	2	4
OG0009551	1	1	1	1	4
OG0009552	1	1	1	1	4
OG0009553	1	0	0	3	4
OG0009554	1	1	1	1	4
OG0009555	1	0	0	3	4
OG0009556	1	1	0	2	4
OG0009557	2	1	0	1	4
OG0009558	1	0	1	2	4
OG0009559	1	1	1	1	4
OG0009560	1	1	1	1	4
OG0009561	2	1	0	1	4
OG0009562	1	1	1	1	4
OG0009563	1	1	1	1	4
OG0009564	1	1	1	1	4
OG0009565	1	0	0	3	4
OG0009566	1	1	1	1	4
OG0009567	1	0	0	3	4
OG0009568	1	1	1	1	4
OG0009569	1	1	1	1	4
OG0009570	1	0	0	3	4
OG0009571	1	1	1	1	4
OG0009572	1	0	0	3	4
OG0009573	1	0	1	2	4
OG0009574	1	1	1	1	4
OG0009575	1	1	1	1	4
OG0009576	2	0	0	2	4
OG0009577	1	1	1	1	4
OG0009578	1	1	1	1	4
OG0009579	1	1	1	1	4
OG0009580	4	0	0	0	4
OG0009581	1	2	0	1	4
OG0009582	1	0	0	3	4
OG0009583	1	1	1	1	4
OG0009584	1	0	0	3	4
OG0009585	1	1	1	1	4
OG0009586	1	1	1	1	4
OG0009587	4	0	0	0	4
OG0009588	1	1	1	1	4
OG0009589	1	0	0	3	4
OG0009590	1	1	1	1	4
OG0009591	1	1	1	1	4
OG0009592	2	0	0	2	4
OG0009593	1	1	1	1	4
OG0009594	1	1	1	1	4
OG0009595	1	0	0	3	4
OG0009596	1	2	0	1	4
OG0009597	4	0	0	0	4
OG0009598	1	0	2	1	4
OG0009599	1	1	1	1	4
OG0009600	1	1	0	2	4
OG0009601	1	1	1	1	4
OG0009602	3	0	0	1	4
OG0009603	1	0	0	3	4
OG0009604	1	1	1	1	4
OG0009605	1	2	0	1	4
OG0009606	1	1	1	1	4
OG0009607	1	1	1	1	4
OG0009608	1	1	1	1	4
OG0009609	1	1	1	1	4
OG0009610	1	1	1	1	4
OG0009611	1	1	1	1	4
OG0009612	1	2	0	1	4
OG0009613	1	1	1	1	4
OG0009614	2	0	1	1	4
OG0009615	1	1	1	1	4
OG0009616	1	1	1	1	4
OG0009617	1	1	1	1	4
OG0009618	1	1	1	1	4
OG0009619	4	0	0	0	4
OG0009620	1	1	1	1	4
OG0009621	1	1	1	1	4
OG0009622	1	1	1	1	4
OG0009623	2	1	0	1	4
OG0009624	1	1	1	1	4
OG0009625	1	1	1	1	4
OG0009626	1	1	1	1	4
OG0009627	1	1	1	1	4
OG0009628	1	1	1	1	4
OG0009629	1	1	1	1	4
OG0009630	1	2	0	1	4
OG0009631	1	1	1	1	4
OG0009632	1	1	1	1	4
OG0009633	1	1	0	2	4
OG0009634	1	0	0	3	4
OG0009635	1	1	1	1	4
OG0009636	1	0	1	2	4
OG0009637	1	2	0	1	4
OG0009638	1	2	0	1	4
OG0009639	1	1	1	1	4
OG0009640	1	1	1	1	4
OG0009641	1	1	1	1	4
OG0009642	1	0	0	3	4
OG0009643	1	1	1	1	4
OG0009644	1	1	1	1	4
OG0009645	1	0	0	3	4
OG0009646	1	1	1	1	4
OG0009647	2	0	1	1	4
OG0009648	1	1	1	1	4
OG0009649	2	0	1	1	4
OG0009650	2	0	0	2	4
OG0009651	2	1	0	1	4
OG0009652	1	1	1	1	4
OG0009653	1	1	1	1	4
OG0009654	1	1	1	1	4
OG0009655	1	2	0	1	4
OG0009656	1	1	1	1	4
OG0009657	1	1	1	1	4
OG0009658	1	1	1	1	4
OG0009659	1	1	1	1	4
OG0009660	1	0	0	3	4
OG0009661	1	1	0	2	4
OG0009662	1	1	1	1	4
OG0009663	1	1	1	1	4
OG0009664	3	0	0	1	4
OG0009665	1	0	2	1	4
OG0009666	1	1	1	1	4
OG0009667	1	0	0	3	4
OG0009668	1	2	0	1	4
OG0009669	1	1	1	1	4
OG0009670	1	1	1	1	4
OG0009671	1	1	1	1	4
OG0009672	1	1	1	1	4
OG0009673	1	1	1	1	4
OG0009674	1	1	0	2	4
OG0009675	1	1	1	1	4
OG0009676	1	1	1	1	4
OG0009677	1	1	1	1	4
OG0009678	1	1	0	2	4
OG0009679	1	1	1	1	4
OG0009680	1	2	0	1	4
OG0009681	1	1	1	1	4
OG0009682	1	1	1	1	4
OG0009683	1	1	1	1	4
OG0009684	1	1	1	1	4
OG0009685	1	0	0	3	4
OG0009686	3	0	0	1	4
OG0009687	1	0	0	3	4
OG0009688	1	1	1	1	4
OG0009689	4	0	0	0	4
OG0009690	1	1	0	2	4
OG0009691	1	1	1	1	4
OG0009692	1	1	1	1	4
OG0009693	1	2	0	1	4
OG0009694	2	0	0	2	4
OG0009695	2	0	0	2	4
OG0009696	1	0	2	1	4
OG0009697	1	1	1	1	4
OG0009698	1	0	2	1	4
OG0009699	1	1	1	1	4
OG0009700	1	1	1	1	4
OG0009701	2	1	1	0	4
OG0009702	2	0	0	2	4
OG0009703	1	1	1	1	4
OG0009704	1	1	1	1	4
OG0009705	1	1	1	1	4
OG0009706	1	1	1	1	4
OG0009707	1	1	1	1	4
OG0009708	1	1	1	1	4
OG0009709	1	1	1	1	4
OG0009710	1	0	0	3	4
OG0009711	1	1	0	2	4
OG0009712	1	1	1	1	4
OG0009713	1	0	2	1	4
OG0009714	1	1	1	1	4
OG0009715	1	1	1	1	4
OG0009716	1	0	1	2	4
OG0009717	1	1	1	1	4
OG0009718	1	1	1	1	4
OG0009719	1	2	0	1	4
OG0009720	1	1	1	1	4
OG0009721	1	1	1	1	4
OG0009722	1	2	0	1	4
OG0009723	1	1	1	1	4
OG0009724	1	0	0	3	4
OG0009725	1	1	1	1	4
OG0009726	2	1	1	0	4
OG0009727	1	2	0	1	4
OG0009728	2	0	0	2	4
OG0009729	1	1	1	1	4
OG0009730	1	1	1	1	4
OG0009731	1	0	2	1	4
OG0009732	1	1	1	1	4
OG0009733	1	1	1	1	4
OG0009734	1	1	1	1	4
OG0009735	1	0	2	1	4
OG0009736	1	1	1	1	4
OG0009737	1	1	1	1	4
OG0009738	1	1	1	1	4
OG0009739	1	1	1	1	4
OG0009740	1	0	1	2	4
OG0009741	4	0	0	0	4
OG0009742	1	1	1	1	4
OG0009743	2	0	0	2	4
OG0009744	2	2	0	0	4
OG0009745	1	2	0	1	4
OG0009746	1	1	1	1	4
OG0009747	1	1	1	1	4
OG0009748	1	0	2	1	4
OG0009749	1	1	1	1	4
OG0009750	1	2	0	1	4
OG0009751	1	1	1	1	4
OG0009752	1	2	0	1	4
OG0009753	1	1	1	1	4
OG0009754	1	1	1	1	4
OG0009755	1	1	1	1	4
OG0009756	1	1	1	1	4
OG0009757	1	0	2	1	4
OG0009758	1	1	1	1	4
OG0009759	1	1	1	1	4
OG0009760	1	1	1	1	4
OG0009761	1	1	1	1	4
OG0009762	1	1	1	1	4
OG0009763	1	1	1	1	4
OG0009764	1	1	0	2	4
OG0009765	1	1	1	1	4
OG0009766	1	0	2	1	4
OG0009767	1	0	0	3	4
OG0009768	1	2	0	1	4
OG0009769	1	1	1	1	4
OG0009770	1	0	2	1	4
OG0009771	4	0	0	0	4
OG0009772	1	1	1	1	4
OG0009773	3	0	0	1	4
OG0009774	2	0	0	2	4
OG0009775	1	1	1	1	4
OG0009776	1	1	1	1	4
OG0009777	1	1	1	1	4
OG0009778	1	1	1	1	4
OG0009779	1	1	1	1	4
OG0009780	1	1	1	1	4
OG0009781	1	1	1	1	4
OG0009782	1	1	1	1	4
OG0009783	1	2	1	0	4
OG0009784	4	0	0	0	4
OG0009785	1	1	1	1	4
OG0009786	1	1	1	1	4
OG0009787	1	1	1	1	4
OG0009788	1	1	1	1	4
OG0009789	4	0	0	0	4
OG0009790	1	1	1	1	4
OG0009791	1	1	0	2	4
OG0009792	2	0	1	1	4
OG0009793	1	1	1	1	4
OG0009794	1	1	1	1	4
OG0009795	2	0	0	2	4
OG0009796	1	2	1	0	4
OG0009797	1	0	1	2	4
OG0009798	1	2	0	1	4
OG0009799	1	1	1	1	4
OG0009800	1	1	1	1	4
OG0009801	1	1	1	1	4
OG0009802	1	1	1	1	4
OG0009803	1	1	1	1	4
OG0009804	1	1	1	1	4
OG0009805	2	0	1	1	4
OG0009806	1	1	1	1	4
OG0009807	1	1	1	1	4
OG0009808	1	1	1	1	4
OG0009809	1	1	1	1	4
OG0009810	1	1	1	1	4
OG0009811	1	1	1	1	4
OG0009812	1	1	1	1	4
OG0009813	1	1	1	1	4
OG0009814	1	1	1	1	4
OG0009815	1	0	0	3	4
OG0009816	1	2	0	1	4
OG0009817	1	1	1	1	4
OG0009818	2	0	0	2	4
OG0009819	1	1	1	1	4
OG0009820	1	1	1	1	4
OG0009821	1	1	1	1	4
OG0009822	1	0	2	1	4
OG0009823	1	1	1	1	4
OG0009824	1	1	1	1	4
OG0009825	1	1	1	1	4
OG0009826	1	1	1	1	4
OG0009827	1	1	1	1	4
OG0009828	1	1	1	1	4
OG0009829	2	1	0	1	4
OG0009830	1	1	1	1	4
OG0009831	1	1	1	1	4
OG0009832	1	1	1	1	4
OG0009833	1	1	1	1	4
OG0009834	1	1	1	1	4
OG0009835	1	1	1	1	4
OG0009836	1	0	0	3	4
OG0009837	1	0	1	2	4
OG0009838	1	1	1	1	4
OG0009839	1	1	1	1	4
OG0009840	1	1	1	1	4
OG0009841	1	1	1	1	4
OG0009842	1	2	0	1	4
OG0009843	1	1	1	1	4
OG0009844	1	1	1	1	4
OG0009845	1	1	1	1	4
OG0009846	1	1	1	1	4
OG0009847	1	2	1	0	4
OG0009848	1	1	2	0	4
OG0009849	1	2	0	1	4
OG0009850	1	1	1	1	4
OG0009851	1	1	1	1	4
OG0009852	1	1	1	1	4
OG0009853	1	1	1	1	4
OG0009854	1	1	0	2	4
OG0009855	1	1	0	2	4
OG0009856	1	1	1	1	4
OG0009857	1	0	2	1	4
OG0009858	1	2	0	1	4
OG0009859	1	1	1	1	4
OG0009860	1	1	1	1	4
OG0009861	1	1	1	1	4
OG0009862	1	0	2	1	4
OG0009863	1	1	0	2	4
OG0009864	2	0	0	2	4
OG0009865	1	1	1	1	4
OG0009866	1	0	0	3	4
OG0009867	1	1	1	1	4
OG0009868	1	1	1	1	4
OG0009869	1	1	1	1	4
OG0009870	1	0	2	1	4
OG0009871	1	1	1	1	4
OG0009872	1	2	0	1	4
OG0009873	1	0	1	2	4
OG0009874	1	2	1	0	4
OG0009875	1	1	1	1	4
OG0009876	1	1	1	1	4
OG0009877	1	1	1	1	4
OG0009878	1	2	0	1	4
OG0009879	1	1	1	1	4
OG0009880	1	1	1	1	4
OG0009881	1	1	1	1	4
OG0009882	1	1	2	0	4
OG0009883	1	1	1	1	4
OG0009884	1	1	1	1	4
OG0009885	1	1	1	1	4
OG0009886	1	1	1	1	4
OG0009887	1	2	0	1	4
OG0009888	1	0	0	3	4
OG0009889	1	1	1	1	4
OG0009890	1	1	1	1	4
OG0009891	1	1	1	1	4
OG0009892	1	1	1	1	4
OG0009893	2	0	0	2	4
OG0009894	1	1	0	2	4
OG0009895	1	0	1	2	4
OG0009896	1	1	1	1	4
OG0009897	1	0	1	2	4
OG0009898	1	1	1	1	4
OG0009899	4	0	0	0	4
OG0009900	1	1	1	1	4
OG0009901	1	1	1	1	4
OG0009902	1	1	1	1	4
OG0009903	1	0	0	3	4
OG0009904	1	1	1	1	4
OG0009905	1	1	1	1	4
OG0009906	1	1	1	1	4
OG0009907	1	1	1	1	4
OG0009908	1	0	2	1	4
OG0009909	1	1	1	1	4
OG0009910	1	1	1	1	4
OG0009911	1	1	1	1	4
OG0009912	1	1	1	1	4
OG0009913	1	1	1	1	4
OG0009914	1	1	1	1	4
OG0009915	3	0	0	1	4
OG0009916	1	0	2	1	4
OG0009917	1	1	1	1	4
OG0009918	1	1	1	1	4
OG0009919	1	0	0	3	4
OG0009920	1	1	1	1	4
OG0009921	1	1	1	1	4
OG0009922	4	0	0	0	4
OG0009923	1	2	0	1	4
OG0009924	1	1	1	1	4
OG0009925	2	0	0	2	4
OG0009926	1	1	1	1	4
OG0009927	1	1	1	1	4
OG0009928	1	0	1	2	4
OG0009929	1	2	0	1	4
OG0009930	1	1	1	1	4
OG0009931	1	1	1	1	4
OG0009932	1	1	1	1	4
OG0009933	1	1	1	1	4
OG0009934	1	1	1	1	4
OG0009935	1	1	1	1	4
OG0009936	1	1	1	1	4
OG0009937	1	1	1	1	4
OG0009938	1	1	1	1	4
OG0009939	1	0	2	1	4
OG0009940	1	0	0	3	4
OG0009941	1	1	1	1	4
OG0009942	1	1	1	1	4
OG0009943	1	1	1	1	4
OG0009944	1	1	1	1	4
OG0009945	1	2	0	1	4
OG0009946	1	1	1	1	4
OG0009947	1	1	1	1	4
OG0009948	1	1	1	1	4
OG0009949	1	1	1	1	4
OG0009950	1	1	0	2	4
OG0009951	1	1	1	1	4
OG0009952	1	1	1	1	4
OG0009953	1	1	1	1	4
OG0009954	1	1	1	1	4
OG0009955	1	0	2	1	4
OG0009956	1	1	1	1	4
OG0009957	1	1	1	1	4
OG0009958	1	1	1	1	4
OG0009959	1	1	1	1	4
OG0009960	1	1	1	1	4
OG0009961	1	1	1	1	4
OG0009962	1	1	1	1	4
OG0009963	1	1	1	1	4
OG0009964	1	0	2	1	4
OG0009965	1	0	0	3	4
OG0009966	1	2	0	1	4
OG0009967	1	1	1	1	4
OG0009968	1	1	1	1	4
OG0009969	1	1	1	1	4
OG0009970	1	1	0	2	4
OG0009971	1	1	1	1	4
OG0009972	1	1	1	1	4
OG0009973	1	1	1	1	4
OG0009974	1	1	1	1	4
OG0009975	1	1	1	1	4
OG0009976	1	1	1	1	4
OG0009977	1	2	0	1	4
OG0009978	1	1	1	1	4
OG0009979	1	1	1	1	4
OG0009980	1	1	1	1	4
OG0009981	1	1	1	1	4
OG0009982	1	1	1	1	4
OG0009983	1	1	1	1	4
OG0009984	1	1	1	1	4
OG0009985	1	1	0	2	4
OG0009986	1	1	1	1	4
OG0009987	1	1	1	1	4
OG0009988	1	1	1	1	4
OG0009989	1	1	1	1	4
OG0009990	3	0	0	1	4
OG0009991	1	1	1	1	4
OG0009992	1	1	1	1	4
OG0009993	1	2	0	1	4
OG0009994	1	1	1	1	4
OG0009995	1	1	1	1	4
OG0009996	1	1	1	1	4
OG0009997	1	0	0	3	4
OG0009998	1	1	1	1	4
OG0009999	1	1	1	1	4
OG0010000	1	0	0	3	4
OG0010001	1	0	2	1	4
OG0010002	1	0	1	2	4
OG0010003	1	1	1	1	4
OG0010004	4	0	0	0	4
OG0010005	1	0	2	1	4
OG0010006	1	0	0	3	4
OG0010007	1	1	1	1	4
OG0010008	1	2	0	1	4
OG0010009	1	1	1	1	4
OG0010010	1	0	0	3	4
OG0010011	1	1	1	1	4
OG0010012	1	1	1	1	4
OG0010013	1	1	1	1	4
OG0010014	1	0	0	3	4
OG0010015	1	1	1	1	4
OG0010016	1	1	1	1	4
OG0010017	1	0	1	2	4
OG0010018	1	1	1	1	4
OG0010019	1	1	1	1	4
OG0010020	1	1	1	1	4
OG0010021	1	1	1	1	4
OG0010022	1	1	1	1	4
OG0010023	1	1	0	2	4
OG0010024	1	1	1	1	4
OG0010025	1	1	1	1	4
OG0010026	1	0	0	3	4
OG0010027	1	1	0	2	4
OG0010028	1	1	1	1	4
OG0010029	1	1	1	1	4
OG0010030	1	0	1	2	4
OG0010031	1	1	1	1	4
OG0010032	1	1	1	1	4
OG0010033	1	1	1	1	4
OG0010034	1	1	1	1	4
OG0010035	1	1	1	1	4
OG0010036	1	0	1	2	4
OG0010037	2	0	0	2	4
OG0010038	1	1	1	1	4
OG0010039	1	1	1	1	4
OG0010040	1	1	1	1	4
OG0010041	1	1	1	1	4
OG0010042	1	2	0	1	4
OG0010043	1	2	0	1	4
OG0010044	1	1	1	1	4
OG0010045	1	1	1	1	4
OG0010046	1	1	1	1	4
OG0010047	1	1	1	1	4
OG0010048	1	1	1	1	4
OG0010049	1	1	1	1	4
OG0010050	1	2	0	1	4
OG0010051	1	1	1	1	4
OG0010052	1	1	1	1	4
OG0010053	1	2	1	0	4
OG0010054	1	1	1	1	4
OG0010055	1	1	1	1	4
OG0010056	1	1	1	1	4
OG0010057	1	1	1	1	4
OG0010058	1	1	0	2	4
OG0010059	2	0	0	2	4
OG0010060	2	1	0	1	4
OG0010061	1	1	0	2	4
OG0010062	1	2	0	1	4
OG0010063	1	1	1	1	4
OG0010064	1	1	1	1	4
OG0010065	1	1	1	1	4
OG0010066	1	1	1	1	4
OG0010067	1	1	1	1	4
OG0010068	1	1	1	1	4
OG0010069	1	1	1	1	4
OG0010070	1	1	1	1	4
OG0010071	1	1	1	1	4
OG0010072	1	1	1	1	4
OG0010073	1	0	2	1	4
OG0010074	1	1	1	1	4
OG0010075	1	1	1	1	4
OG0010076	1	2	0	1	4
OG0010077	1	1	1	1	4
OG0010078	1	1	1	1	4
OG0010079	1	1	1	1	4
OG0010080	1	1	1	1	4
OG0010081	1	1	1	1	4
OG0010082	1	1	1	1	4
OG0010083	1	1	1	1	4
OG0010084	1	1	1	1	4
OG0010085	1	1	1	1	4
OG0010086	1	0	2	1	4
OG0010087	1	1	1	1	4
OG0010088	1	0	1	2	4
OG0010089	1	1	1	1	4
OG0010090	1	1	1	1	4
OG0010091	1	1	1	1	4
OG0010092	1	1	1	1	4
OG0010093	1	1	1	1	4
OG0010094	1	1	1	1	4
OG0010095	1	0	2	1	4
OG0010096	1	1	1	1	4
OG0010097	1	1	1	1	4
OG0010098	1	1	1	1	4
OG0010099	1	2	0	1	4
OG0010100	1	0	1	2	4
OG0010101	1	1	1	1	4
OG0010102	1	1	1	1	4
OG0010103	1	1	1	1	4
OG0010104	1	0	2	1	4
OG0010105	1	1	1	1	4
OG0010106	1	0	0	3	4
OG0010107	1	2	0	1	4
OG0010108	1	1	1	1	4
OG0010109	1	1	1	1	4
OG0010110	1	1	1	1	4
OG0010111	1	1	1	1	4
OG0010112	1	1	0	2	4
OG0010113	1	1	1	1	4
OG0010114	1	2	0	1	4
OG0010115	1	1	1	1	4
OG0010116	1	1	0	2	4
OG0010117	1	1	1	1	4
OG0010118	1	1	1	1	4
OG0010119	1	1	1	1	4
OG0010120	1	1	1	1	4
OG0010121	1	1	1	1	4
OG0010122	1	2	0	1	4
OG0010123	1	1	1	1	4
OG0010124	1	1	1	1	4
OG0010125	1	1	1	1	4
OG0010126	1	1	1	1	4
OG0010127	1	1	1	1	4
OG0010128	1	1	1	1	4
OG0010129	1	0	0	3	4
OG0010130	1	1	1	1	4
OG0010131	1	0	2	1	4
OG0010132	1	1	1	1	4
OG0010133	1	1	1	1	4
OG0010134	1	1	1	1	4
OG0010135	1	1	1	1	4
OG0010136	1	1	1	1	4
OG0010137	1	1	1	1	4
OG0010138	1	1	1	1	4
OG0010139	1	0	1	2	4
OG0010140	1	0	1	2	4
OG0010141	4	0	0	0	4
OG0010142	1	1	1	1	4
OG0010143	1	1	1	1	4
OG0010144	1	1	1	1	4
OG0010145	1	1	1	1	4
OG0010146	1	0	0	3	4
OG0010147	1	1	1	1	4
OG0010148	1	0	1	2	4
OG0010149	1	1	1	1	4
OG0010150	1	2	1	0	4
OG0010151	1	1	1	1	4
OG0010152	1	1	0	2	4
OG0010153	1	0	1	2	4
OG0010154	1	1	1	1	4
OG0010155	1	1	1	1	4
OG0010156	1	1	1	1	4
OG0010157	2	0	1	1	4
OG0010158	1	1	1	1	4
OG0010159	1	1	1	1	4
OG0010160	1	1	0	2	4
OG0010161	1	1	1	1	4
OG0010162	1	1	1	1	4
OG0010163	1	1	1	1	4
OG0010164	1	1	1	1	4
OG0010165	1	1	1	1	4
OG0010166	1	2	0	1	4
OG0010167	1	1	1	1	4
OG0010168	1	2	0	1	4
OG0010169	1	1	1	1	4
OG0010170	1	3	0	0	4
OG0010171	1	1	1	1	4
OG0010172	1	2	0	1	4
OG0010173	1	1	1	1	4
OG0010174	1	1	1	1	4
OG0010175	1	1	0	2	4
OG0010176	1	2	0	1	4
OG0010177	1	1	1	1	4
OG0010178	1	1	1	1	4
OG0010179	1	0	0	3	4
OG0010180	1	1	1	1	4
OG0010181	1	1	1	1	4
OG0010182	1	1	1	1	4
OG0010183	1	1	1	1	4
OG0010184	1	1	1	1	4
OG0010185	1	1	1	1	4
OG0010186	1	1	1	1	4
OG0010187	1	1	1	1	4
OG0010188	1	1	0	2	4
OG0010189	1	1	0	2	4
OG0010190	1	2	0	1	4
OG0010191	1	0	2	1	4
OG0010192	1	1	1	1	4
OG0010193	2	0	0	2	4
OG0010194	1	1	0	2	4
OG0010195	1	0	2	1	4
OG0010196	1	1	1	1	4
OG0010197	1	1	1	1	4
OG0010198	1	1	1	1	4
OG0010199	1	1	1	1	4
OG0010200	1	1	1	1	4
OG0010201	1	1	1	1	4
OG0010202	1	1	1	1	4
OG0010203	1	1	1	1	4
OG0010204	1	1	1	1	4
OG0010205	1	1	1	1	4
OG0010206	1	1	1	1	4
OG0010207	1	1	1	1	4
OG0010208	1	1	1	1	4
OG0010209	1	2	0	1	4
OG0010210	1	1	1	1	4
OG0010211	1	1	1	1	4
OG0010212	1	1	1	1	4
OG0010213	1	1	1	1	4
OG0010214	1	1	1	1	4
OG0010215	1	1	1	1	4
OG0010216	1	1	1	1	4
OG0010217	1	1	1	1	4
OG0010218	3	0	0	1	4
OG0010219	1	1	1	1	4
OG0010220	1	1	1	1	4
OG0010221	1	1	1	1	4
OG0010222	1	0	0	3	4
OG0010223	1	1	1	1	4
OG0010224	1	1	1	1	4
OG0010225	1	1	1	1	4
OG0010226	1	1	1	1	4
OG0010227	1	1	1	1	4
OG0010228	1	1	1	1	4
OG0010229	1	1	1	1	4
OG0010230	1	1	1	1	4
OG0010231	1	0	0	3	4
OG0010232	2	1	0	1	4
OG0010233	1	1	1	1	4
OG0010234	1	1	1	1	4
OG0010235	1	1	1	1	4
OG0010236	1	1	1	1	4
OG0010237	1	1	1	1	4
OG0010238	1	1	1	1	4
OG0010239	1	1	1	1	4
OG0010240	1	1	1	1	4
OG0010241	1	0	2	1	4
OG0010242	1	1	1	1	4
OG0010243	1	1	1	1	4
OG0010244	1	1	1	1	4
OG0010245	1	1	1	1	4
OG0010246	1	1	1	1	4
OG0010247	1	1	1	1	4
OG0010248	1	1	1	1	4
OG0010249	1	1	1	1	4
OG0010250	1	0	2	1	4
OG0010251	1	1	1	1	4
OG0010252	1	0	2	1	4
OG0010253	1	1	1	1	4
OG0010254	1	1	1	1	4
OG0010255	1	1	1	1	4
OG0010256	2	2	0	0	4
OG0010257	1	0	2	1	4
OG0010258	1	0	1	2	4
OG0010259	1	1	1	1	4
OG0010260	1	1	1	1	4
OG0010261	1	1	1	1	4
OG0010262	1	1	1	1	4
OG0010263	1	1	1	1	4
OG0010264	1	1	1	1	4
OG0010265	1	0	1	2	4
OG0010266	1	1	1	1	4
OG0010267	1	1	1	1	4
OG0010268	1	2	0	1	4
OG0010269	1	1	1	1	4
OG0010270	1	1	1	1	4
OG0010271	1	1	1	1	4
OG0010272	1	1	1	1	4
OG0010273	1	1	1	1	4
OG0010274	1	1	0	2	4
OG0010275	1	0	2	1	4
OG0010276	1	1	1	1	4
OG0010277	1	1	1	1	4
OG0010278	1	0	2	1	4
OG0010279	1	1	1	1	4
OG0010280	1	1	1	1	4
OG0010281	1	1	1	1	4
OG0010282	1	1	1	1	4
OG0010283	1	1	1	1	4
OG0010284	1	1	1	1	4
OG0010285	1	1	1	1	4
OG0010286	1	1	0	2	4
OG0010287	1	1	1	1	4
OG0010288	1	1	1	1	4
OG0010289	1	1	1	1	4
OG0010290	1	1	1	1	4
OG0010291	1	1	1	1	4
OG0010292	1	0	2	1	4
OG0010293	1	1	1	1	4
OG0010294	1	1	1	1	4
OG0010295	2	0	1	1	4
OG0010296	1	0	0	3	4
OG0010297	1	1	1	1	4
OG0010298	1	1	1	1	4
OG0010299	1	1	1	1	4
OG0010300	1	1	1	1	4
OG0010301	1	1	1	1	4
OG0010302	1	1	1	1	4
OG0010303	1	0	0	3	4
OG0010304	1	1	1	1	4
OG0010305	1	1	1	1	4
OG0010306	1	1	1	1	4
OG0010307	1	1	1	1	4
OG0010308	4	0	0	0	4
OG0010309	1	0	2	1	4
OG0010310	1	1	1	1	4
OG0010311	1	1	1	1	4
OG0010312	1	0	1	2	4
OG0010313	1	1	1	1	4
OG0010314	1	1	1	1	4
OG0010315	1	1	1	1	4
OG0010316	1	1	1	1	4
OG0010317	1	1	1	1	4
OG0010318	1	1	1	1	4
OG0010319	1	1	1	1	4
OG0010320	1	1	1	1	4
OG0010321	1	1	1	1	4
OG0010322	1	1	1	1	4
OG0010323	1	1	1	1	4
OG0010324	1	1	1	1	4
OG0010325	2	1	0	1	4
OG0010326	1	2	0	1	4
OG0010327	1	1	1	1	4
OG0010328	1	1	1	1	4
OG0010329	1	0	1	2	4
OG0010330	1	1	1	1	4
OG0010331	1	1	1	1	4
OG0010332	1	1	1	1	4
OG0010333	1	1	1	1	4
OG0010334	1	1	1	1	4
OG0010335	1	1	1	1	4
OG0010336	1	1	1	1	4
OG0010337	1	1	1	1	4
OG0010338	1	1	1	1	4
OG0010339	1	1	1	1	4
OG0010340	1	2	0	1	4
OG0010341	1	1	1	1	4
OG0010342	1	1	0	2	4
OG0010343	1	1	1	1	4
OG0010344	1	1	1	1	4
OG0010345	1	1	1	1	4
OG0010346	1	2	0	1	4
OG0010347	1	1	1	1	4
OG0010348	2	0	0	2	4
OG0010349	1	1	1	1	4
OG0010350	1	1	1	1	4
OG0010351	1	1	1	1	4
OG0010352	1	1	1	1	4
OG0010353	1	2	0	1	4
OG0010354	1	2	0	1	4
OG0010355	1	1	1	1	4
OG0010356	2	2	0	0	4
OG0010357	1	1	1	1	4
OG0010358	1	1	1	1	4
OG0010359	1	1	1	1	4
OG0010360	1	1	1	1	4
OG0010361	1	1	1	1	4
OG0010362	1	1	1	1	4
OG0010363	1	2	0	1	4
OG0010364	1	2	0	1	4
OG0010365	1	1	1	1	4
OG0010366	1	1	1	1	4
OG0010367	1	1	1	1	4
OG0010368	1	1	1	1	4
OG0010369	1	1	1	1	4
OG0010370	1	1	1	1	4
OG0010371	2	0	1	1	4
OG0010372	1	1	1	1	4
OG0010373	1	2	0	1	4
OG0010374	1	1	0	2	4
OG0010375	1	1	1	1	4
OG0010376	1	1	1	1	4
OG0010377	1	0	2	1	4
OG0010378	1	1	1	1	4
OG0010379	1	1	1	1	4
OG0010380	1	1	1	1	4
OG0010381	1	1	1	1	4
OG0010382	1	1	1	1	4
OG0010383	1	1	1	1	4
OG0010384	1	0	2	1	4
OG0010385	1	1	1	1	4
OG0010386	1	1	1	1	4
OG0010387	1	1	1	1	4
OG0010388	1	1	1	1	4
OG0010389	1	1	1	1	4
OG0010390	1	1	1	1	4
OG0010391	3	0	0	1	4
OG0010392	1	1	1	1	4
OG0010393	1	0	0	3	4
OG0010394	1	1	1	1	4
OG0010395	1	1	1	1	4
OG0010396	1	1	1	1	4
OG0010397	1	1	1	1	4
OG0010398	1	1	1	1	4
OG0010399	1	1	1	1	4
OG0010400	1	1	1	1	4
OG0010401	1	2	0	1	4
OG0010402	1	2	0	1	4
OG0010403	1	1	1	1	4
OG0010404	1	1	1	1	4
OG0010405	1	1	1	1	4
OG0010406	1	1	1	1	4
OG0010407	1	1	1	1	4
OG0010408	1	0	2	1	4
OG0010409	1	1	1	1	4
OG0010410	1	1	1	1	4
OG0010411	1	1	1	1	4
OG0010412	1	1	1	1	4
OG0010413	1	1	1	1	4
OG0010414	1	1	1	1	4
OG0010415	1	1	1	1	4
OG0010416	1	1	1	1	4
OG0010417	1	1	1	1	4
OG0010418	1	0	0	3	4
OG0010419	1	1	1	1	4
OG0010420	1	1	1	1	4
OG0010421	1	1	1	1	4
OG0010422	1	0	0	3	4
OG0010423	1	1	1	1	4
OG0010424	1	1	1	1	4
OG0010425	1	1	1	1	4
OG0010426	2	0	1	1	4
OG0010427	1	0	1	2	4
OG0010428	1	1	2	0	4
OG0010429	1	1	1	1	4
OG0010430	1	1	1	1	4
OG0010431	1	1	1	1	4
OG0010432	1	1	1	1	4
OG0010433	1	1	0	2	4
OG0010434	1	1	1	1	4
OG0010435	1	0	2	1	4
OG0010436	1	1	1	1	4
OG0010437	1	0	0	3	4
OG0010438	1	1	1	1	4
OG0010439	1	0	0	3	4
OG0010440	1	2	0	1	4
OG0010441	1	1	1	1	4
OG0010442	1	1	1	1	4
OG0010443	2	1	0	1	4
OG0010444	1	1	1	1	4
OG0010445	1	1	1	1	4
OG0010446	1	1	1	1	4
OG0010447	1	1	1	1	4
OG0010448	1	1	1	1	4
OG0010449	1	1	1	1	4
OG0010450	1	1	1	1	4
OG0010451	1	1	1	1	4
OG0010452	1	1	1	1	4
OG0010453	1	1	1	1	4
OG0010454	1	1	0	2	4
OG0010455	1	1	1	1	4
OG0010456	1	0	2	1	4
OG0010457	1	1	1	1	4
OG0010458	1	1	1	1	4
OG0010459	1	1	1	1	4
OG0010460	1	1	1	1	4
OG0010461	1	2	0	1	4
OG0010462	1	1	1	1	4
OG0010463	1	1	1	1	4
OG0010464	1	1	1	1	4
OG0010465	1	1	1	1	4
OG0010466	1	1	1	1	4
OG0010467	1	0	1	2	4
OG0010468	1	1	1	1	4
OG0010469	1	1	2	0	4
OG0010470	1	0	0	3	4
OG0010471	1	1	1	1	4
OG0010472	1	1	1	1	4
OG0010473	1	1	1	1	4
OG0010474	1	0	2	1	4
OG0010475	1	1	1	1	4
OG0010476	1	1	1	1	4
OG0010477	1	1	1	1	4
OG0010478	1	1	1	1	4
OG0010479	1	1	1	1	4
OG0010480	1	1	1	1	4
OG0010481	1	0	2	1	4
OG0010482	1	1	1	1	4
OG0010483	1	1	1	1	4
OG0010484	1	1	1	1	4
OG0010485	1	2	0	1	4
OG0010486	1	1	1	1	4
OG0010487	1	1	1	1	4
OG0010488	1	1	1	1	4
OG0010489	1	1	1	1	4
OG0010490	1	1	0	2	4
OG0010491	1	1	1	1	4
OG0010492	1	1	1	1	4
OG0010493	1	0	0	3	4
OG0010494	1	2	0	1	4
OG0010495	1	1	1	1	4
OG0010496	1	1	1	1	4
OG0010497	1	1	1	1	4
OG0010498	1	0	2	1	4
OG0010499	1	1	1	1	4
OG0010500	1	1	1	1	4
OG0010501	1	0	0	3	4
OG0010502	1	1	1	1	4
OG0010503	1	2	0	1	4
OG0010504	1	0	1	2	4
OG0010505	1	1	1	1	4
OG0010506	1	1	1	1	4
OG0010507	1	1	0	2	4
OG0010508	1	0	2	1	4
OG0010509	1	1	1	1	4
OG0010510	1	1	1	1	4
OG0010511	1	1	1	1	4
OG0010512	1	1	0	2	4
OG0010513	2	0	1	1	4
OG0010514	1	1	1	1	4
OG0010515	1	2	0	1	4
OG0010516	1	1	1	1	4
OG0010517	1	2	0	1	4
OG0010518	1	0	1	2	4
OG0010519	1	1	1	1	4
OG0010520	1	0	2	1	4
OG0010521	1	1	1	1	4
OG0010522	1	1	1	1	4
OG0010523	1	1	1	1	4
OG0010524	1	1	1	1	4
OG0010525	1	1	1	1	4
OG0010526	1	1	1	1	4
OG0010527	1	1	1	1	4
OG0010528	1	1	1	1	4
OG0010529	1	2	0	1	4
OG0010530	1	1	1	1	4
OG0010531	1	1	1	1	4
OG0010532	1	1	1	1	4
OG0010533	1	1	1	1	4
OG0010534	1	1	1	1	4
OG0010535	1	1	1	1	4
OG0010536	1	1	1	1	4
OG0010537	1	1	1	1	4
OG0010538	1	1	1	1	4
OG0010539	1	1	1	1	4
OG0010540	1	0	0	3	4
OG0010541	1	1	1	1	4
OG0010542	2	0	1	1	4
OG0010543	1	1	1	1	4
OG0010544	1	1	1	1	4
OG0010545	1	1	1	1	4
OG0010546	1	1	1	1	4
OG0010547	1	0	0	3	4
OG0010548	1	1	1	1	4
OG0010549	1	1	1	1	4
OG0010550	1	1	1	1	4
OG0010551	1	1	1	1	4
OG0010552	1	1	1	1	4
OG0010553	1	0	2	1	4
OG0010554	1	1	1	1	4
OG0010555	1	1	0	2	4
OG0010556	1	2	0	1	4
OG0010557	1	1	1	1	4
OG0010558	1	1	1	1	4
OG0010559	1	1	1	1	4
OG0010560	1	1	1	1	4
OG0010561	1	2	0	1	4
OG0010562	1	1	1	1	4
OG0010563	1	1	1	1	4
OG0010564	1	0	2	1	4
OG0010565	1	1	0	2	4
OG0010566	1	1	1	1	4
OG0010567	1	2	0	1	4
OG0010568	1	1	1	1	4
OG0010569	1	1	1	1	4
OG0010570	1	1	1	1	4
OG0010571	1	0	1	2	4
OG0010572	1	1	1	1	4
OG0010573	1	0	1	2	4
OG0010574	1	1	0	2	4
OG0010575	1	1	1	1	4
OG0010576	1	1	1	1	4
OG0010577	1	2	0	1	4
OG0010578	1	1	1	1	4
OG0010579	1	1	1	1	4
OG0010580	1	1	1	1	4
OG0010581	1	1	0	2	4
OG0010582	1	1	0	2	4
OG0010583	1	1	1	1	4
OG0010584	1	1	1	1	4
OG0010585	1	1	1	1	4
OG0010586	1	1	1	1	4
OG0010587	1	1	1	1	4
OG0010588	1	1	1	1	4
OG0010589	1	2	0	1	4
OG0010590	1	0	0	3	4
OG0010591	1	1	1	1	4
OG0010592	1	0	2	1	4
OG0010593	1	1	1	1	4
OG0010594	1	2	0	1	4
OG0010595	2	0	0	2	4
OG0010596	1	0	2	1	4
OG0010597	2	0	0	2	4
OG0010598	1	1	1	1	4
OG0010599	1	0	2	1	4
OG0010600	1	1	1	1	4
OG0010601	1	2	0	1	4
OG0010602	1	1	1	1	4
OG0010603	1	1	0	2	4
OG0010604	1	1	1	1	4
OG0010605	1	0	0	3	4
OG0010606	1	1	1	1	4
OG0010607	1	1	1	1	4
OG0010608	1	1	1	1	4
OG0010609	1	0	2	1	4
OG0010610	1	1	1	1	4
OG0010611	1	1	1	1	4
OG0010612	1	1	1	1	4
OG0010613	1	1	1	1	4
OG0010614	1	1	1	1	4
OG0010615	2	1	0	1	4
OG0010616	1	1	1	1	4
OG0010617	1	0	2	1	4
OG0010618	1	1	1	1	4
OG0010619	1	1	1	1	4
OG0010620	1	1	1	1	4
OG0010621	1	1	1	1	4
OG0010622	1	1	0	2	4
OG0010623	1	1	1	1	4
OG0010624	1	1	1	1	4
OG0010625	1	0	2	1	4
OG0010626	1	1	1	1	4
OG0010627	1	1	1	1	4
OG0010628	1	1	1	1	4
OG0010629	1	1	1	1	4
OG0010630	1	1	1	1	4
OG0010631	1	0	2	1	4
OG0010632	1	1	0	2	4
OG0010633	1	1	1	1	4
OG0010634	1	1	1	1	4
OG0010635	1	1	0	2	4
OG0010636	1	1	1	1	4
OG0010637	1	1	1	1	4
OG0010638	1	2	0	1	4
OG0010639	1	1	1	1	4
OG0010640	1	0	2	1	4
OG0010641	1	1	1	1	4
OG0010642	1	1	1	1	4
OG0010643	1	1	1	1	4
OG0010644	1	1	1	1	4
OG0010645	1	2	0	1	4
OG0010646	1	1	1	1	4
OG0010647	1	2	0	1	4
OG0010648	1	0	1	2	4
OG0010649	1	1	1	1	4
OG0010650	1	0	0	3	4
OG0010651	1	1	1	1	4
OG0010652	1	1	1	1	4
OG0010653	1	1	1	1	4
OG0010654	1	1	1	1	4
OG0010655	1	1	1	1	4
OG0010656	1	1	1	1	4
OG0010657	1	1	1	1	4
OG0010658	1	1	1	1	4
OG0010659	1	2	0	1	4
OG0010660	1	1	1	1	4
OG0010661	1	1	1	1	4
OG0010662	1	1	1	1	4
OG0010663	1	1	1	1	4
OG0010664	2	1	0	1	4
OG0010665	1	1	1	1	4
OG0010666	2	1	0	1	4
OG0010667	1	1	1	1	4
OG0010668	1	2	0	1	4
OG0010669	1	1	1	1	4
OG0010670	1	1	1	1	4
OG0010671	1	1	1	1	4
OG0010672	1	1	1	1	4
OG0010673	1	2	0	1	4
OG0010674	1	1	1	1	4
OG0010675	1	0	2	1	4
OG0010676	1	1	0	2	4
OG0010677	1	0	0	3	4
OG0010678	1	1	0	2	4
OG0010679	1	1	1	1	4
OG0010680	1	1	1	1	4
OG0010681	1	1	1	1	4
OG0010682	1	1	1	1	4
OG0010683	1	1	0	2	4
OG0010684	1	1	1	1	4
OG0010685	1	0	2	1	4
OG0010686	1	1	1	1	4
OG0010687	2	0	0	2	4
OG0010688	1	1	1	1	4
OG0010689	1	1	1	1	4
OG0010690	1	1	1	1	4
OG0010691	1	1	1	1	4
OG0010692	1	1	1	1	4
OG0010693	1	0	1	2	4
OG0010694	1	1	1	1	4
OG0010695	1	1	1	1	4
OG0010696	1	1	1	1	4
OG0010697	1	1	1	1	4
OG0010698	1	1	1	1	4
OG0010699	1	1	1	1	4
OG0010700	1	0	2	1	4
OG0010701	1	0	0	3	4
OG0010702	1	1	1	1	4
OG0010703	1	1	1	1	4
OG0010704	1	1	1	1	4
OG0010705	1	2	0	1	4
OG0010706	1	0	1	2	4
OG0010707	1	1	1	1	4
OG0010708	1	1	1	1	4
OG0010709	1	0	1	2	4
OG0010710	1	2	0	1	4
OG0010711	1	1	1	1	4
OG0010712	1	1	1	1	4
OG0010713	1	1	0	2	4
OG0010714	1	1	1	1	4
OG0010715	2	1	0	1	4
OG0010716	1	1	1	1	4
OG0010717	1	1	0	2	4
OG0010718	1	1	1	1	4
OG0010719	1	1	1	1	4
OG0010720	1	1	1	1	4
OG0010721	1	1	1	1	4
OG0010722	1	1	1	1	4
OG0010723	1	1	1	1	4
OG0010724	1	1	1	1	4
OG0010725	1	1	1	1	4
OG0010726	1	1	1	1	4
OG0010727	1	1	1	1	4
OG0010728	1	1	1	1	4
OG0010729	1	0	2	1	4
OG0010730	1	1	1	1	4
OG0010731	1	1	1	1	4
OG0010732	1	1	1	1	4
OG0010733	1	2	0	1	4
OG0010734	1	1	1	1	4
OG0010735	1	1	1	1	4
OG0010736	1	1	1	1	4
OG0010737	1	2	0	1	4
OG0010738	1	1	1	1	4
OG0010739	1	1	1	1	4
OG0010740	1	1	1	1	4
OG0010741	1	1	1	1	4
OG0010742	1	1	1	1	4
OG0010743	1	1	1	1	4
OG0010744	1	1	1	1	4
OG0010745	1	1	1	1	4
OG0010746	1	1	1	1	4
OG0010747	1	1	1	1	4
OG0010748	1	1	1	1	4
OG0010749	1	1	1	1	4
OG0010750	1	1	1	1	4
OG0010751	1	2	0	1	4
OG0010752	1	0	1	2	4
OG0010753	1	1	1	1	4
OG0010754	1	1	1	1	4
OG0010755	1	2	0	1	4
OG0010756	1	1	1	1	4
OG0010757	1	1	1	1	4
OG0010758	2	1	0	1	4
OG0010759	1	1	1	1	4
OG0010760	1	1	1	1	4
OG0010761	1	2	0	1	4
OG0010762	1	1	1	1	4
OG0010763	1	1	1	1	4
OG0010764	1	2	0	1	4
OG0010765	1	1	1	1	4
OG0010766	1	1	1	1	4
OG0010767	1	1	1	1	4
OG0010768	1	1	1	1	4
OG0010769	1	1	0	2	4
OG0010770	1	2	0	1	4
OG0010771	1	1	1	1	4
OG0010772	1	1	1	1	4
OG0010773	2	1	1	0	4
OG0010774	1	1	1	1	4
OG0010775	1	1	1	1	4
OG0010776	1	1	1	1	4
OG0010777	1	1	1	1	4
OG0010778	1	1	1	1	4
OG0010779	1	0	2	1	4
OG0010780	1	1	1	1	4
OG0010781	1	1	1	1	4
OG0010782	1	2	0	1	4
OG0010783	1	1	1	1	4
OG0010784	1	0	2	1	4
OG0010785	1	1	1	1	4
OG0010786	1	1	1	1	4
OG0010787	1	1	1	1	4
OG0010788	1	0	0	3	4
OG0010789	1	1	1	1	4
OG0010790	1	1	1	1	4
OG0010791	1	0	1	2	4
OG0010792	1	1	1	1	4
OG0010793	1	1	1	1	4
OG0010794	1	1	1	1	4
OG0010795	1	1	1	1	4
OG0010796	1	1	1	1	4
OG0010797	1	1	1	1	4
OG0010798	1	1	1	1	4
OG0010799	1	0	1	2	4
OG0010800	1	1	1	1	4
OG0010801	1	1	1	1	4
OG0010802	1	1	1	1	4
OG0010803	1	1	1	1	4
OG0010804	1	1	1	1	4
OG0010805	1	0	0	3	4
OG0010806	1	2	0	1	4
OG0010807	1	1	1	1	4
OG0010808	1	1	1	1	4
OG0010809	1	1	1	1	4
OG0010810	1	1	0	2	4
OG0010811	1	1	1	1	4
OG0010812	1	1	1	1	4
OG0010813	1	0	0	3	4
OG0010814	1	1	1	1	4
OG0010815	1	1	1	1	4
OG0010816	2	1	0	1	4
OG0010817	1	2	0	1	4
OG0010818	1	1	1	1	4
OG0010819	1	2	0	1	4
OG0010820	1	1	1	1	4
OG0010821	1	1	1	1	4
OG0010822	1	1	1	1	4
OG0010823	1	1	1	1	4
OG0010824	1	1	1	1	4
OG0010825	1	1	1	1	4
OG0010826	1	2	0	1	4
OG0010827	1	1	1	1	4
OG0010828	1	1	1	1	4
OG0010829	1	1	1	1	4
OG0010830	1	0	0	3	4
OG0010831	1	1	1	1	4
OG0010832	1	1	1	1	4
OG0010833	1	1	1	1	4
OG0010834	1	0	2	1	4
OG0010835	1	1	1	1	4
OG0010836	1	1	1	1	4
OG0010837	1	1	1	1	4
OG0010838	1	1	1	1	4
OG0010839	1	1	1	1	4
OG0010840	1	1	1	1	4
OG0010841	1	0	1	2	4
OG0010842	1	1	1	1	4
OG0010843	1	1	1	1	4
OG0010844	1	1	1	1	4
OG0010845	1	0	2	1	4
OG0010846	1	1	1	1	4
OG0010847	1	1	1	1	4
OG0010848	1	1	1	1	4
OG0010849	1	1	1	1	4
OG0010850	1	1	1	1	4
OG0010851	1	1	1	1	4
OG0010852	1	1	1	1	4
OG0010853	1	0	0	3	4
OG0010854	1	1	1	1	4
OG0010855	1	2	0	1	4
OG0010856	1	1	1	1	4
OG0010857	1	1	1	1	4
OG0010858	1	1	1	1	4
OG0010859	1	1	1	1	4
OG0010860	1	1	1	1	4
OG0010861	1	1	1	1	4
OG0010862	1	1	1	1	4
OG0010863	1	1	1	1	4
OG0010864	1	0	0	3	4
OG0010865	1	1	1	1	4
OG0010866	1	1	1	1	4
OG0010867	1	1	1	1	4
OG0010868	1	2	0	1	4
OG0010869	1	1	1	1	4
OG0010870	1	1	1	1	4
OG0010871	1	1	1	1	4
OG0010872	1	1	1	1	4
OG0010873	1	2	0	1	4
OG0010874	1	1	1	1	4
OG0010875	1	1	1	1	4
OG0010876	1	1	1	1	4
OG0010877	2	0	1	1	4
OG0010878	1	1	1	1	4
OG0010879	1	1	1	1	4
OG0010880	1	1	1	1	4
OG0010881	1	1	1	1	4
OG0010882	1	0	2	1	4
OG0010883	1	1	1	1	4
OG0010884	1	1	0	2	4
OG0010885	1	2	0	1	4
OG0010886	1	1	1	1	4
OG0010887	1	0	2	1	4
OG0010888	1	1	1	1	4
OG0010889	1	0	2	1	4
OG0010890	1	1	0	2	4
OG0010891	2	0	0	2	4
OG0010892	1	1	1	1	4
OG0010893	1	1	1	1	4
OG0010894	3	0	0	1	4
OG0010895	1	1	1	1	4
OG0010896	1	1	1	1	4
OG0010897	1	1	1	1	4
OG0010898	1	2	0	1	4
OG0010899	1	1	0	2	4
OG0010900	1	1	1	1	4
OG0010901	1	1	1	1	4
OG0010902	1	1	1	1	4
OG0010903	1	1	0	2	4
OG0010904	1	1	1	1	4
OG0010905	1	0	0	3	4
OG0010906	1	1	1	1	4
OG0010907	1	1	1	1	4
OG0010908	1	1	1	1	4
OG0010909	1	1	1	1	4
OG0010910	1	2	0	1	4
OG0010911	1	0	2	1	4
OG0010912	1	2	0	1	4
OG0010913	1	1	1	1	4
OG0010914	1	1	1	1	4
OG0010915	1	1	1	1	4
OG0010916	1	0	0	3	4
OG0010917	1	1	1	1	4
OG0010918	1	1	1	1	4
OG0010919	1	1	1	1	4
OG0010920	1	1	1	1	4
OG0010921	1	1	1	1	4
OG0010922	1	1	1	1	4
OG0010923	1	1	1	1	4
OG0010924	1	1	1	1	4
OG0010925	1	1	1	1	4
OG0010926	1	1	1	1	4
OG0010927	1	1	1	1	4
OG0010928	1	0	0	3	4
OG0010929	1	1	1	1	4
OG0010930	1	0	0	3	4
OG0010931	1	1	1	1	4
OG0010932	1	1	0	2	4
OG0010933	1	1	2	0	4
OG0010934	1	2	0	1	4
OG0010935	1	1	1	1	4
OG0010936	2	0	0	2	4
OG0010937	1	2	0	1	4
OG0010938	1	0	2	1	4
OG0010939	1	2	0	1	4
OG0010940	1	1	1	1	4
OG0010941	1	1	1	1	4
OG0010942	1	1	1	1	4
OG0010943	1	1	1	1	4
OG0010944	1	2	0	1	4
OG0010945	1	1	1	1	4
OG0010946	1	1	1	1	4
OG0010947	1	1	1	1	4
OG0010948	1	2	0	1	4
OG0010949	1	1	1	1	4
OG0010950	1	1	1	1	4
OG0010951	1	1	1	1	4
OG0010952	1	0	0	3	4
OG0010953	1	1	1	1	4
OG0010954	1	0	0	3	4
OG0010955	1	1	1	1	4
OG0010956	1	1	1	1	4
OG0010957	1	1	1	1	4
OG0010958	2	0	0	2	4
OG0010959	1	1	1	1	4
OG0010960	1	1	1	1	4
OG0010961	1	0	0	3	4
OG0010962	1	2	0	1	4
OG0010963	1	1	1	1	4
OG0010964	1	2	0	1	4
OG0010965	1	1	1	1	4
OG0010966	1	0	0	3	4
OG0010967	1	1	1	1	4
OG0010968	1	1	1	1	4
OG0010969	1	0	0	3	4
OG0010970	1	1	1	1	4
OG0010971	1	1	1	1	4
OG0010972	1	1	1	1	4
OG0010973	1	1	1	1	4
OG0010974	1	2	0	1	4
OG0010975	1	1	1	1	4
OG0010976	1	1	1	1	4
OG0010977	1	1	1	1	4
OG0010978	1	1	1	1	4
OG0010979	1	1	1	1	4
OG0010980	1	1	1	1	4
OG0010981	1	1	1	1	4
OG0010982	1	0	0	3	4
OG0010983	1	1	1	1	4
OG0010984	1	2	0	1	4
OG0010985	1	1	1	1	4
OG0010986	1	1	1	1	4
OG0010987	1	1	0	2	4
OG0010988	1	0	0	3	4
OG0010989	1	1	1	1	4
OG0010990	1	1	1	1	4
OG0010991	1	1	1	1	4
OG0010992	1	1	1	1	4
OG0010993	1	0	1	2	4
OG0010994	1	1	1	1	4
OG0010995	1	1	1	1	4
OG0010996	1	1	1	1	4
OG0010997	1	1	1	1	4
OG0010998	1	1	1	1	4
OG0010999	1	1	1	1	4
OG0011000	1	1	1	1	4
OG0011001	1	1	1	1	4
OG0011002	1	1	1	1	4
OG0011003	1	0	2	1	4
OG0011004	1	2	0	1	4
OG0011005	1	1	1	1	4
OG0011006	1	1	1	1	4
OG0011007	2	0	1	1	4
OG0011008	1	1	1	1	4
OG0011009	1	1	0	2	4
OG0011010	1	1	1	1	4
OG0011011	1	1	1	1	4
OG0011012	1	1	1	1	4
OG0011013	1	1	1	1	4
OG0011014	1	2	1	0	4
OG0011015	1	1	0	2	4
OG0011016	1	1	1	1	4
OG0011017	1	1	1	1	4
OG0011018	1	1	1	1	4
OG0011019	1	0	0	3	4
OG0011020	1	1	1	1	4
OG0011021	1	2	0	1	4
OG0011022	1	2	0	1	4
OG0011023	1	1	1	1	4
OG0011024	1	1	1	1	4
OG0011025	1	1	1	1	4
OG0011026	1	0	0	3	4
OG0011027	1	1	0	2	4
OG0011028	1	1	2	0	4
OG0011029	1	2	0	1	4
OG0011030	1	3	0	0	4
OG0011031	1	1	2	0	4
OG0011032	1	0	3	0	4
OG0011033	1	1	1	1	4
OG0011034	1	1	1	1	4
OG0011035	1	1	1	1	4
OG0011036	1	1	1	1	4
OG0011037	1	1	0	2	4
OG0011038	1	1	1	1	4
OG0011039	1	1	1	1	4
OG0011040	1	1	1	1	4
OG0011041	0	4	0	0	4
OG0011042	0	2	2	0	4
OG0011043	0	4	0	0	4
OG0011044	0	4	0	0	4
OG0011045	0	4	0	0	4
OG0011046	0	3	1	0	4
OG0011047	0	4	0	0	4
OG0011048	0	4	0	0	4
OG0011049	0	4	0	0	4
OG0011050	0	4	0	0	4
OG0011051	0	4	0	0	4
OG0011052	0	1	1	2	4
OG0011053	0	4	0	0	4
OG0011054	0	4	0	0	4
OG0011055	0	4	0	0	4
OG0011056	0	4	0	0	4
OG0011057	0	3	0	1	4
OG0011058	0	4	0	0	4
OG0011059	0	4	0	0	4
OG0011060	0	4	0	0	4
OG0011061	0	4	0	0	4
OG0011062	0	4	0	0	4
OG0011063	0	3	1	0	4
OG0011064	0	4	0	0	4
OG0011065	0	4	0	0	4
OG0011066	0	4	0	0	4
OG0011067	0	4	0	0	4
OG0011068	0	4	0	0	4
OG0011069	0	3	0	1	4
OG0011070	0	4	0	0	4
OG0011071	0	4	0	0	4
OG0011072	0	4	0	0	4
OG0011073	0	4	0	0	4
OG0011074	0	4	0	0	4
OG0011075	0	4	0	0	4
OG0011076	0	4	0	0	4
OG0011077	0	4	0	0	4
OG0011078	0	4	0	0	4
OG0011079	0	4	0	0	4
OG0011080	0	4	0	0	4
OG0011081	0	4	0	0	4
OG0011082	0	4	0	0	4
OG0011083	0	4	0	0	4
OG0011084	0	4	0	0	4
OG0011085	0	4	0	0	4
OG0011086	0	4	0	0	4
OG0011087	0	4	0	0	4
OG0011088	0	4	0	0	4
OG0011089	0	4	0	0	4
OG0011090	0	4	0	0	4
OG0011091	0	4	0	0	4
OG0011092	0	4	0	0	4
OG0011093	0	4	0	0	4
OG0011094	0	4	0	0	4
OG0011095	0	4	0	0	4
OG0011096	0	4	0	0	4
OG0011097	0	4	0	0	4
OG0011098	0	4	0	0	4
OG0011099	0	4	0	0	4
OG0011100	0	4	0	0	4
OG0011101	0	4	0	0	4
OG0011102	0	4	0	0	4
OG0011103	0	4	0	0	4
OG0011104	0	4	0	0	4
OG0011105	0	4	0	0	4
OG0011106	0	4	0	0	4
OG0011107	0	4	0	0	4
OG0011108	0	4	0	0	4
OG0011109	0	4	0	0	4
OG0011110	0	4	0	0	4
OG0011111	0	4	0	0	4
OG0011112	0	4	0	0	4
OG0011113	0	4	0	0	4
OG0011114	0	4	0	0	4
OG0011115	0	4	0	0	4
OG0011116	0	4	0	0	4
OG0011117	0	4	0	0	4
OG0011118	0	4	0	0	4
OG0011119	0	4	0	0	4
OG0011120	0	3	0	1	4
OG0011121	0	4	0	0	4
OG0011122	0	4	0	0	4
OG0011123	0	4	0	0	4
OG0011124	0	4	0	0	4
OG0011125	0	4	0	0	4
OG0011126	0	4	0	0	4
OG0011127	0	4	0	0	4
OG0011128	0	4	0	0	4
OG0011129	0	4	0	0	4
OG0011130	0	4	0	0	4
OG0011131	0	4	0	0	4
OG0011132	0	4	0	0	4
OG0011133	0	4	0	0	4
OG0011134	0	4	0	0	4
OG0011135	0	4	0	0	4
OG0011136	0	4	0	0	4
OG0011137	0	4	0	0	4
OG0011138	0	4	0	0	4
OG0011139	0	4	0	0	4
OG0011140	0	4	0	0	4
OG0011141	0	4	0	0	4
OG0011142	0	4	0	0	4
OG0011143	0	1	0	3	4
OG0011144	0	4	0	0	4
OG0011145	0	4	0	0	4
OG0011146	0	4	0	0	4
OG0011147	0	4	0	0	4
OG0011148	0	4	0	0	4
OG0011149	0	4	0	0	4
OG0011150	0	4	0	0	4
OG0011151	0	4	0	0	4
OG0011152	0	4	0	0	4
OG0011153	0	4	0	0	4
OG0011154	0	1	3	0	4
OG0011155	0	4	0	0	4
OG0011156	0	4	0	0	4
OG0011157	0	4	0	0	4
OG0011158	0	4	0	0	4
OG0011159	0	4	0	0	4
OG0011160	0	4	0	0	4
OG0011161	0	4	0	0	4
OG0011162	0	4	0	0	4
OG0011163	0	4	0	0	4
OG0011164	0	4	0	0	4
OG0011165	0	4	0	0	4
OG0011166	0	4	0	0	4
OG0011167	0	4	0	0	4
OG0011168	0	4	0	0	4
OG0011169	0	4	0	0	4
OG0011170	0	4	0	0	4
OG0011171	0	4	0	0	4
OG0011172	0	4	0	0	4
OG0011173	0	4	0	0	4
OG0011174	0	4	0	0	4
OG0011175	0	4	0	0	4
OG0011176	0	4	0	0	4
OG0011177	0	4	0	0	4
OG0011178	0	4	0	0	4
OG0011179	0	4	0	0	4
OG0011180	0	4	0	0	4
OG0011181	0	4	0	0	4
OG0011182	0	4	0	0	4
OG0011183	0	4	0	0	4
OG0011184	0	4	0	0	4
OG0011185	0	4	0	0	4
OG0011186	0	4	0	0	4
OG0011187	0	4	0	0	4
OG0011188	0	4	0	0	4
OG0011189	0	4	0	0	4
OG0011190	0	4	0	0	4
OG0011191	0	4	0	0	4
OG0011192	0	4	0	0	4
OG0011193	0	4	0	0	4
OG0011194	0	4	0	0	4
OG0011195	0	4	0	0	4
OG0011196	0	1	3	0	4
OG0011197	0	4	0	0	4
OG0011198	0	3	0	1	4
OG0011199	0	4	0	0	4
OG0011200	0	4	0	0	4
OG0011201	0	4	0	0	4
OG0011202	0	4	0	0	4
OG0011203	0	4	0	0	4
OG0011204	0	4	0	0	4
OG0011205	0	4	0	0	4
OG0011206	0	4	0	0	4
OG0011207	0	3	1	0	4
OG0011208	0	4	0	0	4
OG0011209	0	4	0	0	4
OG0011210	0	4	0	0	4
OG0011211	0	4	0	0	4
OG0011212	0	4	0	0	4
OG0011213	0	4	0	0	4
OG0011214	0	3	0	1	4
OG0011215	0	4	0	0	4
OG0011216	0	4	0	0	4
OG0011217	0	4	0	0	4
OG0011218	0	4	0	0	4
OG0011219	0	4	0	0	4
OG0011220	0	1	3	0	4
OG0011221	0	4	0	0	4
OG0011222	0	4	0	0	4
OG0011223	0	4	0	0	4
OG0011224	0	1	3	0	4
OG0011225	0	4	0	0	4
OG0011226	0	4	0	0	4
OG0011227	0	4	0	0	4
OG0011228	0	4	0	0	4
OG0011229	0	4	0	0	4
OG0011230	0	4	0	0	4
OG0011231	0	4	0	0	4
OG0011232	0	4	0	0	4
OG0011233	0	4	0	0	4
OG0011234	0	4	0	0	4
OG0011235	0	4	0	0	4
OG0011236	0	4	0	0	4
OG0011237	0	4	0	0	4
OG0011238	0	4	0	0	4
OG0011239	0	4	0	0	4
OG0011240	0	4	0	0	4
OG0011241	0	4	0	0	4
OG0011242	0	4	0	0	4
OG0011243	0	3	1	0	4
OG0011244	0	4	0	0	4
OG0011245	0	4	0	0	4
OG0011246	0	3	1	0	4
OG0011247	0	4	0	0	4
OG0011248	0	4	0	0	4
OG0011249	0	4	0	0	4
OG0011250	0	2	2	0	4
OG0011251	0	3	1	0	4
OG0011252	0	4	0	0	4
OG0011253	0	4	0	0	4
OG0011254	0	4	0	0	4
OG0011255	0	4	0	0	4
OG0011256	0	4	0	0	4
OG0011257	0	4	0	0	4
OG0011258	0	3	0	1	4
OG0011259	0	4	0	0	4
OG0011260	0	4	0	0	4
OG0011261	0	4	0	0	4
OG0011262	0	1	1	2	4
OG0011263	0	1	3	0	4
OG0011264	0	4	0	0	4
OG0011265	0	4	0	0	4
OG0011266	0	3	0	1	4
OG0011267	0	4	0	0	4
OG0011268	0	4	0	0	4
OG0011269	0	4	0	0	4
OG0011270	0	4	0	0	4
OG0011271	0	4	0	0	4
OG0011272	0	3	0	1	4
OG0011273	0	4	0	0	4
OG0011274	0	4	0	0	4
OG0011275	0	4	0	0	4
OG0011276	0	4	0	0	4
OG0011277	0	4	0	0	4
OG0011278	0	4	0	0	4
OG0011279	0	4	0	0	4
OG0011280	0	4	0	0	4
OG0011281	0	1	3	0	4
OG0011282	0	3	0	1	4
OG0011283	0	4	0	0	4
OG0011284	0	4	0	0	4
OG0011285	0	4	0	0	4
OG0011286	0	4	0	0	4
OG0011287	0	4	0	0	4
OG0011288	0	4	0	0	4
OG0011289	0	1	3	0	4
OG0011290	0	4	0	0	4
OG0011291	0	4	0	0	4
OG0011292	0	2	2	0	4
OG0011293	0	4	0	0	4
OG0011294	0	2	1	1	4
OG0011295	0	4	0	0	4
OG0011296	0	4	0	0	4
OG0011297	0	1	0	3	4
OG0011298	0	3	1	0	4
OG0011299	0	4	0	0	4
OG0011300	0	4	0	0	4
OG0011301	0	4	0	0	4
OG0011302	0	4	0	0	4
OG0011303	0	4	0	0	4
OG0011304	0	3	1	0	4
OG0011305	0	4	0	0	4
OG0011306	0	1	1	2	4
OG0011307	0	4	0	0	4
OG0011308	0	3	1	0	4
OG0011309	0	1	2	1	4
OG0011310	0	2	1	1	4
OG0011311	0	1	3	0	4
OG0011312	0	4	0	0	4
OG0011313	0	4	0	0	4
OG0011314	0	4	0	0	4
OG0011315	0	4	0	0	4
OG0011316	0	4	0	0	4
OG0011317	0	4	0	0	4
OG0011318	0	4	0	0	4
OG0011319	0	4	0	0	4
OG0011320	0	1	0	3	4
OG0011321	0	2	1	1	4
OG0011322	0	3	0	1	4
OG0011323	0	3	0	1	4
OG0011324	0	4	0	0	4
OG0011325	0	4	0	0	4
OG0011326	0	1	3	0	4
OG0011327	0	3	0	1	4
OG0011328	0	4	0	0	4
OG0011329	0	4	0	0	4
OG0011330	0	4	0	0	4
OG0011331	0	4	0	0	4
OG0011332	0	4	0	0	4
OG0011333	0	4	0	0	4
OG0011334	0	4	0	0	4
OG0011335	0	3	1	0	4
OG0011336	0	3	1	0	4
OG0011337	0	4	0	0	4
OG0011338	0	1	3	0	4
OG0011339	0	1	3	0	4
OG0011340	0	4	0	0	4
OG0011341	0	4	0	0	4
OG0011342	0	2	2	0	4
OG0011343	0	2	2	0	4
OG0011344	0	2	1	1	4
OG0011345	0	2	2	0	4
OG0011346	0	4	0	0	4
OG0011347	0	4	0	0	4
OG0011348	0	4	0	0	4
OG0011349	0	2	2	0	4
OG0011350	0	4	0	0	4
OG0011351	0	4	0	0	4
OG0011352	0	4	0	0	4
OG0011353	0	1	3	0	4
OG0011354	0	4	0	0	4
OG0011355	0	4	0	0	4
OG0011356	0	4	0	0	4
OG0011357	0	1	3	0	4
OG0011358	0	4	0	0	4
OG0011359	0	4	0	0	4
OG0011360	0	4	0	0	4
OG0011361	0	3	1	0	4
OG0011362	0	4	0	0	4
OG0011363	0	4	0	0	4
OG0011364	0	1	1	2	4
OG0011365	0	4	0	0	4
OG0011366	0	4	0	0	4
OG0011367	0	3	1	0	4
OG0011368	0	1	2	1	4
OG0011369	0	4	0	0	4
OG0011370	0	1	1	2	4
OG0011371	0	4	0	0	4
OG0011372	0	4	0	0	4
OG0011373	0	4	0	0	4
OG0011374	0	4	0	0	4
OG0011375	0	1	1	2	4
OG0011376	0	1	2	1	4
OG0011377	0	4	0	0	4
OG0011378	0	4	0	0	4
OG0011379	0	4	0	0	4
OG0011380	0	4	0	0	4
OG0011381	0	4	0	0	4
OG0011382	0	4	0	0	4
OG0011383	0	4	0	0	4
OG0011384	0	4	0	0	4
OG0011385	0	4	0	0	4
OG0011386	0	4	0	0	4
OG0011387	0	4	0	0	4
OG0011388	0	4	0	0	4
OG0011389	0	4	0	0	4
OG0011390	0	4	0	0	4
OG0011391	0	4	0	0	4
OG0011392	0	4	0	0	4
OG0011393	0	0	4	0	4
OG0011394	0	0	4	0	4
OG0011395	0	0	4	0	4
OG0011396	0	0	4	0	4
OG0011397	0	0	4	0	4
OG0011398	0	0	4	0	4
OG0011399	0	0	4	0	4
OG0011400	0	0	4	0	4
OG0011401	0	0	3	1	4
OG0011402	0	0	4	0	4
OG0011403	0	0	4	0	4
OG0011404	0	0	4	0	4
OG0011405	0	0	4	0	4
OG0011406	0	0	4	0	4
OG0011407	0	0	4	0	4
OG0011408	0	0	4	0	4
OG0011409	0	0	4	0	4
OG0011410	0	0	4	0	4
OG0011411	0	0	4	0	4
OG0011412	0	0	4	0	4
OG0011413	0	0	4	0	4
OG0011414	0	0	4	0	4
OG0011415	0	0	4	0	4
OG0011416	0	0	4	0	4
OG0011417	0	0	4	0	4
OG0011418	0	0	4	0	4
OG0011419	0	0	4	0	4
OG0011420	0	0	4	0	4
OG0011421	0	0	4	0	4
OG0011422	0	0	4	0	4
OG0011423	0	0	4	0	4
OG0011424	0	0	4	0	4
OG0011425	0	0	4	0	4
OG0011426	0	0	4	0	4
OG0011427	0	0	4	0	4
OG0011428	0	0	4	0	4
OG0011429	0	0	4	0	4
OG0011430	0	0	4	0	4
OG0011431	0	0	4	0	4
OG0011432	0	0	4	0	4
OG0011433	0	0	4	0	4
OG0011434	0	0	4	0	4
OG0011435	0	0	4	0	4
OG0011436	0	0	3	1	4
OG0011437	0	0	4	0	4
OG0011438	0	0	4	0	4
OG0011439	0	0	4	0	4
OG0011440	0	0	4	0	4
OG0011441	0	0	4	0	4
OG0011442	0	0	4	0	4
OG0011443	0	0	4	0	4
OG0011444	0	0	4	0	4
OG0011445	0	0	4	0	4
OG0011446	0	0	4	0	4
OG0011447	0	0	4	0	4
OG0011448	0	0	4	0	4
OG0011449	0	0	4	0	4
OG0011450	0	0	4	0	4
OG0011451	0	0	4	0	4
OG0011452	0	0	4	0	4
OG0011453	0	0	4	0	4
OG0011454	0	0	4	0	4
OG0011455	0	0	4	0	4
OG0011456	0	0	4	0	4
OG0011457	0	0	4	0	4
OG0011458	0	0	4	0	4
OG0011459	0	0	4	0	4
OG0011460	0	0	4	0	4
OG0011461	0	0	4	0	4
OG0011462	0	0	4	0	4
OG0011463	0	0	4	0	4
OG0011464	0	0	4	0	4
OG0011465	0	0	4	0	4
OG0011466	0	0	4	0	4
OG0011467	0	0	4	0	4
OG0011468	0	0	4	0	4
OG0011469	0	0	4	0	4
OG0011470	0	0	4	0	4
OG0011471	0	0	4	0	4
OG0011472	0	0	4	0	4
OG0011473	0	0	4	0	4
OG0011474	0	0	4	0	4
OG0011475	0	0	4	0	4
OG0011476	0	0	4	0	4
OG0011477	0	0	4	0	4
OG0011478	0	0	4	0	4
OG0011479	0	0	4	0	4
OG0011480	0	0	4	0	4
OG0011481	0	0	4	0	4
OG0011482	0	0	4	0	4
OG0011483	0	0	4	0	4
OG0011484	0	0	4	0	4
OG0011485	0	0	4	0	4
OG0011486	0	0	4	0	4
OG0011487	0	0	4	0	4
OG0011488	0	0	4	0	4
OG0011489	0	0	4	0	4
OG0011490	0	0	4	0	4
OG0011491	0	0	4	0	4
OG0011492	0	0	4	0	4
OG0011493	0	0	4	0	4
OG0011494	0	0	4	0	4
OG0011495	0	0	4	0	4
OG0011496	0	0	4	0	4
OG0011497	0	0	4	0	4
OG0011498	0	0	4	0	4
OG0011499	0	0	4	0	4
OG0011500	0	0	4	0	4
OG0011501	0	0	4	0	4
OG0011502	0	0	4	0	4
OG0011503	0	0	4	0	4
OG0011504	0	0	4	0	4
OG0011505	0	0	4	0	4
OG0011506	0	0	4	0	4
OG0011507	0	0	4	0	4
OG0011508	0	0	4	0	4
OG0011509	0	0	4	0	4
OG0011510	0	0	4	0	4
OG0011511	0	0	4	0	4
OG0011512	0	0	4	0	4
OG0011513	0	0	4	0	4
OG0011514	0	0	4	0	4
OG0011515	0	0	4	0	4
OG0011516	0	0	4	0	4
OG0011517	0	0	4	0	4
OG0011518	0	0	4	0	4
OG0011519	0	0	4	0	4
OG0011520	0	0	4	0	4
OG0011521	0	0	4	0	4
OG0011522	0	0	4	0	4
OG0011523	0	0	4	0	4
OG0011524	0	0	4	0	4
OG0011525	0	0	4	0	4
OG0011526	0	0	4	0	4
OG0011527	0	0	4	0	4
OG0011528	0	0	4	0	4
OG0011529	0	0	4	0	4
OG0011530	0	0	4	0	4
OG0011531	0	0	4	0	4
OG0011532	0	0	4	0	4
OG0011533	0	0	4	0	4
OG0011534	0	0	4	0	4
OG0011535	0	0	4	0	4
OG0011536	0	0	4	0	4
OG0011537	0	0	4	0	4
OG0011538	0	0	4	0	4
OG0011539	0	0	4	0	4
OG0011540	0	0	4	0	4
OG0011541	0	0	4	0	4
OG0011542	0	0	4	0	4
OG0011543	0	0	4	0	4
OG0011544	0	0	4	0	4
OG0011545	0	0	4	0	4
OG0011546	0	0	4	0	4
OG0011547	0	0	4	0	4
OG0011548	0	0	1	3	4
OG0011549	0	0	4	0	4
OG0011550	0	0	4	0	4
OG0011551	0	0	4	0	4
OG0011552	0	0	4	0	4
OG0011553	0	0	4	0	4
OG0011554	0	0	4	0	4
OG0011555	0	0	4	0	4
OG0011556	0	0	4	0	4
OG0011557	0	0	4	0	4
OG0011558	0	0	4	0	4
OG0011559	0	0	4	0	4
OG0011560	0	0	4	0	4
OG0011561	0	0	4	0	4
OG0011562	0	0	4	0	4
OG0011563	0	0	4	0	4
OG0011564	0	0	4	0	4
OG0011565	0	0	4	0	4
OG0011566	0	0	4	0	4
OG0011567	0	0	4	0	4
OG0011568	0	0	4	0	4
OG0011569	0	0	4	0	4
OG0011570	0	0	0	4	4
OG0011571	0	0	0	4	4
OG0011572	0	0	0	4	4
OG0011573	0	0	0	4	4
OG0011574	0	0	0	4	4
OG0011575	0	0	0	4	4
OG0011576	0	0	0	4	4
OG0011577	0	0	0	4	4
OG0011578	0	0	0	4	4
OG0011579	0	0	0	4	4
OG0011580	0	0	0	4	4
OG0011581	0	0	0	4	4
OG0011582	0	0	0	4	4
OG0011583	0	0	0	4	4
OG0011584	0	0	0	4	4
OG0011585	0	0	0	4	4
OG0011586	0	0	0	4	4
OG0011587	0	0	0	4	4
OG0011588	0	0	0	4	4
OG0011589	0	0	0	4	4
OG0011590	0	0	0	4	4
OG0011591	0	0	0	4	4
OG0011592	0	0	0	4	4
OG0011593	0	0	0	4	4
OG0011594	0	0	0	4	4
OG0011595	0	0	0	4	4
OG0011596	0	0	0	4	4
OG0011597	0	0	0	4	4
OG0011598	0	0	0	4	4
OG0011599	0	0	0	4	4
OG0011600	0	0	0	4	4
OG0011601	0	0	0	4	4
OG0011602	0	0	0	4	4
OG0011603	0	0	0	4	4
OG0011604	0	0	0	4	4
OG0011605	0	0	0	4	4
OG0011606	0	0	0	4	4
OG0011607	0	0	0	4	4
OG0011608	0	0	0	4	4
OG0011609	0	0	0	4	4
OG0011610	0	0	0	4	4
OG0011611	0	0	0	4	4
OG0011612	0	0	0	4	4
OG0011613	0	0	0	4	4
OG0011614	0	0	0	4	4
OG0011615	0	0	0	4	4
OG0011616	0	0	0	4	4
OG0011617	0	0	0	4	4
OG0011618	0	0	0	4	4
OG0011619	0	0	0	4	4
OG0011620	0	0	0	4	4
OG0011621	0	0	0	4	4
OG0011622	0	0	0	4	4
OG0011623	0	0	0	4	4
OG0011624	0	0	0	4	4
OG0011625	0	0	0	4	4
OG0011626	0	0	0	4	4
OG0011627	0	0	0	4	4
OG0011628	0	0	0	4	4
OG0011629	0	0	0	4	4
OG0011630	0	0	0	4	4
OG0011631	0	0	0	4	4
OG0011632	0	0	0	4	4
OG0011633	0	0	0	4	4
OG0011634	0	0	0	4	4
OG0011635	0	0	0	4	4
OG0011636	0	0	0	4	4
OG0011637	0	0	0	4	4
OG0011638	0	0	0	4	4
OG0011639	0	0	0	4	4
OG0011640	0	0	0	4	4
OG0011641	0	0	0	4	4
OG0011642	0	0	0	4	4
OG0011643	0	0	0	4	4
OG0011644	0	0	0	4	4
OG0011645	0	0	0	4	4
OG0011646	0	0	0	4	4
OG0011647	0	0	0	4	4
OG0011648	0	0	0	4	4
OG0011649	0	0	0	4	4
OG0011650	0	0	0	4	4
OG0011651	0	0	0	4	4
OG0011652	0	0	0	4	4
OG0011653	0	0	0	4	4
OG0011654	0	0	0	4	4
OG0011655	0	0	0	4	4
OG0011656	0	0	0	4	4
OG0011657	0	0	0	4	4
OG0011658	0	0	0	4	4
OG0011659	0	0	0	4	4
OG0011660	0	0	0	4	4
OG0011661	0	0	0	4	4
OG0011662	0	0	0	4	4
OG0011663	0	0	0	4	4
OG0011664	0	0	0	4	4
OG0011665	0	0	0	4	4
OG0011666	0	0	0	4	4
OG0011667	0	0	0	4	4
OG0011668	0	0	0	4	4
OG0011669	0	0	0	4	4
OG0011670	0	0	0	4	4
OG0011671	0	0	0	4	4
OG0011672	0	0	0	4	4
OG0011673	0	0	0	4	4
OG0011674	0	0	0	4	4
OG0011675	0	0	0	4	4
OG0011676	0	0	0	4	4
OG0011677	0	0	0	4	4
OG0011678	0	0	0	4	4
OG0011679	0	0	0	4	4
OG0011680	0	0	0	4	4
OG0011681	0	0	0	4	4
OG0011682	0	0	0	4	4
OG0011683	0	0	0	4	4
OG0011684	0	0	0	4	4
OG0011685	0	0	0	4	4
OG0011686	0	0	0	4	4
OG0011687	0	0	0	4	4
OG0011688	0	0	0	4	4
OG0011689	0	0	0	4	4
OG0011690	0	0	0	4	4
OG0011691	0	0	0	4	4
OG0011692	0	0	0	4	4
OG0011693	0	0	0	4	4
OG0011694	0	0	0	4	4
OG0011695	0	0	0	4	4
OG0011696	0	0	0	4	4
OG0011697	0	0	0	4	4
OG0011698	0	0	0	4	4
OG0011699	0	0	0	4	4
OG0011700	0	0	0	4	4
OG0011701	0	0	0	4	4
OG0011702	0	0	0	4	4
OG0011703	0	0	0	4	4
OG0011704	0	0	0	4	4
OG0011705	0	0	0	4	4
OG0011706	0	0	0	4	4
OG0011707	0	0	0	4	4
OG0011708	0	0	0	4	4
OG0011709	0	0	0	4	4
OG0011710	0	0	0	4	4
OG0011711	0	0	0	4	4
OG0011712	0	0	0	4	4
OG0011713	0	0	0	4	4
OG0011714	0	0	0	4	4
OG0011715	0	0	0	4	4
OG0011716	0	0	0	4	4
OG0011717	0	0	0	4	4
OG0011718	0	0	0	4	4
OG0011719	0	0	0	4	4
OG0011720	0	0	0	4	4
OG0011721	0	0	0	4	4
OG0011722	0	0	0	4	4
OG0011723	0	0	0	4	4
OG0011724	0	0	0	4	4
OG0011725	0	0	0	4	4
OG0011726	0	0	0	4	4
OG0011727	0	0	0	4	4
OG0011728	0	0	0	4	4
OG0011729	0	0	0	4	4
OG0011730	0	0	0	4	4
OG0011731	0	0	0	4	4
OG0011732	0	0	0	4	4
OG0011733	0	0	0	4	4
OG0011734	0	0	0	4	4
OG0011735	0	0	0	4	4
OG0011736	0	0	0	4	4
OG0011737	0	0	0	4	4
OG0011738	0	0	0	4	4
OG0011739	0	0	0	4	4
OG0011740	0	0	0	4	4
OG0011741	0	0	0	4	4
OG0011742	0	0	0	4	4
OG0011743	0	0	0	4	4
OG0011744	0	0	0	4	4
OG0011745	0	0	0	4	4
OG0011746	0	0	0	4	4
OG0011747	0	0	0	4	4
OG0011748	0	0	0	4	4
OG0011749	0	0	0	4	4
OG0011750	0	0	0	4	4
OG0011751	0	0	0	4	4
OG0011752	0	0	0	4	4
OG0011753	0	0	0	4	4
OG0011754	0	0	0	4	4
OG0011755	0	0	0	4	4
OG0011756	0	0	0	4	4
OG0011757	0	0	0	4	4
OG0011758	0	0	0	4	4
OG0011759	0	0	0	4	4
OG0011760	0	0	0	4	4
OG0011761	0	0	0	4	4
OG0011762	0	0	0	4	4
OG0011763	0	0	0	4	4
OG0011764	0	0	0	4	4
OG0011765	0	0	0	4	4
OG0011766	0	0	0	4	4
OG0011767	0	0	0	4	4
OG0011768	0	0	0	4	4
OG0011769	0	0	0	4	4
OG0011770	0	0	0	4	4
OG0011771	0	0	0	4	4
OG0011772	0	0	0	4	4
OG0011773	0	0	0	4	4
OG0011774	0	0	0	4	4
OG0011775	0	0	0	4	4
OG0011776	0	0	0	4	4
OG0011777	0	0	0	4	4
OG0011778	0	0	0	4	4
OG0011779	0	0	0	4	4
OG0011780	0	0	0	4	4
OG0011781	0	0	0	4	4
OG0011782	0	0	0	4	4
OG0011783	0	0	0	4	4
OG0011784	0	0	0	4	4
OG0011785	0	0	0	4	4
OG0011786	0	0	0	4	4
OG0011787	0	0	0	4	4
OG0011788	0	0	0	4	4
OG0011789	0	0	0	4	4
OG0011790	0	0	0	4	4
OG0011791	0	0	0	4	4
OG0011792	0	0	0	4	4
OG0011793	0	0	0	4	4
OG0011794	0	0	0	4	4
OG0011795	0	0	0	4	4
OG0011796	0	0	0	4	4
OG0011797	0	0	0	4	4
OG0011798	0	0	0	4	4
OG0011799	0	0	0	4	4
OG0011800	0	0	0	4	4
OG0011801	0	0	0	4	4
OG0011802	0	0	0	4	4
OG0011803	0	0	0	4	4
OG0011804	0	0	0	4	4
OG0011805	3	0	0	0	3
OG0011806	3	0	0	0	3
OG0011807	2	0	0	1	3
OG0011808	3	0	0	0	3
OG0011809	3	0	0	0	3
OG0011810	2	0	0	1	3
OG0011811	3	0	0	0	3
OG0011812	1	0	0	2	3
OG0011813	3	0	0	0	3
OG0011814	3	0	0	0	3
OG0011815	3	0	0	0	3
OG0011816	3	0	0	0	3
OG0011817	2	0	0	1	3
OG0011818	2	0	0	1	3
OG0011819	2	0	0	1	3
OG0011820	3	0	0	0	3
OG0011821	3	0	0	0	3
OG0011822	2	0	0	1	3
OG0011823	3	0	0	0	3
OG0011824	3	0	0	0	3
OG0011825	3	0	0	0	3
OG0011826	3	0	0	0	3
OG0011827	3	0	0	0	3
OG0011828	3	0	0	0	3
OG0011829	3	0	0	0	3
OG0011830	3	0	0	0	3
OG0011831	2	1	0	0	3
OG0011832	1	0	0	2	3
OG0011833	3	0	0	0	3
OG0011834	2	0	0	1	3
OG0011835	3	0	0	0	3
OG0011836	2	0	0	1	3
OG0011837	3	0	0	0	3
OG0011838	3	0	0	0	3
OG0011839	3	0	0	0	3
OG0011840	3	0	0	0	3
OG0011841	3	0	0	0	3
OG0011842	3	0	0	0	3
OG0011843	3	0	0	0	3
OG0011844	2	0	0	1	3
OG0011845	2	0	0	1	3
OG0011846	2	0	0	1	3
OG0011847	3	0	0	0	3
OG0011848	2	0	0	1	3
OG0011849	3	0	0	0	3
OG0011850	2	0	0	1	3
OG0011851	2	0	0	1	3
OG0011852	2	0	0	1	3
OG0011853	2	0	0	1	3
OG0011854	3	0	0	0	3
OG0011855	3	0	0	0	3
OG0011856	3	0	0	0	3
OG0011857	3	0	0	0	3
OG0011858	3	0	0	0	3
OG0011859	3	0	0	0	3
OG0011860	3	0	0	0	3
OG0011861	3	0	0	0	3
OG0011862	3	0	0	0	3
OG0011863	2	0	0	1	3
OG0011864	2	0	0	1	3
OG0011865	3	0	0	0	3
OG0011866	3	0	0	0	3
OG0011867	3	0	0	0	3
OG0011868	3	0	0	0	3
OG0011869	3	0	0	0	3
OG0011870	3	0	0	0	3
OG0011871	1	1	0	1	3
OG0011872	3	0	0	0	3
OG0011873	3	0	0	0	3
OG0011874	3	0	0	0	3
OG0011875	3	0	0	0	3
OG0011876	3	0	0	0	3
OG0011877	3	0	0	0	3
OG0011878	3	0	0	0	3
OG0011879	3	0	0	0	3
OG0011880	3	0	0	0	3
OG0011881	3	0	0	0	3
OG0011882	2	0	0	1	3
OG0011883	2	0	0	1	3
OG0011884	2	0	0	1	3
OG0011885	2	1	0	0	3
OG0011886	3	0	0	0	3
OG0011887	3	0	0	0	3
OG0011888	3	0	0	0	3
OG0011889	2	0	0	1	3
OG0011890	3	0	0	0	3
OG0011891	2	0	0	1	3
OG0011892	3	0	0	0	3
OG0011893	2	0	0	1	3
OG0011894	3	0	0	0	3
OG0011895	3	0	0	0	3
OG0011896	3	0	0	0	3
OG0011897	3	0	0	0	3
OG0011898	1	0	0	2	3
OG0011899	3	0	0	0	3
OG0011900	2	0	0	1	3
OG0011901	3	0	0	0	3
OG0011902	3	0	0	0	3
OG0011903	3	0	0	0	3
OG0011904	1	0	0	2	3
OG0011905	2	0	0	1	3
OG0011906	2	0	0	1	3
OG0011907	3	0	0	0	3
OG0011908	2	0	0	1	3
OG0011909	3	0	0	0	3
OG0011910	3	0	0	0	3
OG0011911	2	0	0	1	3
OG0011912	3	0	0	0	3
OG0011913	2	0	0	1	3
OG0011914	3	0	0	0	3
OG0011915	3	0	0	0	3
OG0011916	3	0	0	0	3
OG0011917	3	0	0	0	3
OG0011918	3	0	0	0	3
OG0011919	3	0	0	0	3
OG0011920	1	0	0	2	3
OG0011921	2	0	0	1	3
OG0011922	1	2	0	0	3
OG0011923	3	0	0	0	3
OG0011924	3	0	0	0	3
OG0011925	3	0	0	0	3
OG0011926	2	0	0	1	3
OG0011927	2	0	0	1	3
OG0011928	3	0	0	0	3
OG0011929	2	0	0	1	3
OG0011930	1	0	0	2	3
OG0011931	2	0	0	1	3
OG0011932	1	0	0	2	3
OG0011933	3	0	0	0	3
OG0011934	2	0	0	1	3
OG0011935	2	0	0	1	3
OG0011936	2	0	0	1	3
OG0011937	2	0	1	0	3
OG0011938	3	0	0	0	3
OG0011939	1	0	0	2	3
OG0011940	3	0	0	0	3
OG0011941	3	0	0	0	3
OG0011942	3	0	0	0	3
OG0011943	2	0	0	1	3
OG0011944	2	0	0	1	3
OG0011945	2	0	0	1	3
OG0011946	2	0	0	1	3
OG0011947	3	0	0	0	3
OG0011948	3	0	0	0	3
OG0011949	3	0	0	0	3
OG0011950	3	0	0	0	3
OG0011951	3	0	0	0	3
OG0011952	2	0	0	1	3
OG0011953	3	0	0	0	3
OG0011954	3	0	0	0	3
OG0011955	2	0	0	1	3
OG0011956	1	0	0	2	3
OG0011957	3	0	0	0	3
OG0011958	3	0	0	0	3
OG0011959	3	0	0	0	3
OG0011960	2	0	0	1	3
OG0011961	3	0	0	0	3
OG0011962	3	0	0	0	3
OG0011963	3	0	0	0	3
OG0011964	2	0	0	1	3
OG0011965	2	0	0	1	3
OG0011966	1	2	0	0	3
OG0011967	2	0	0	1	3
OG0011968	2	0	0	1	3
OG0011969	3	0	0	0	3
OG0011970	3	0	0	0	3
OG0011971	3	0	0	0	3
OG0011972	3	0	0	0	3
OG0011973	3	0	0	0	3
OG0011974	3	0	0	0	3
OG0011975	2	0	1	0	3
OG0011976	3	0	0	0	3
OG0011977	3	0	0	0	3
OG0011978	3	0	0	0	3
OG0011979	3	0	0	0	3
OG0011980	2	1	0	0	3
OG0011981	3	0	0	0	3
OG0011982	2	0	0	1	3
OG0011983	3	0	0	0	3
OG0011984	2	0	0	1	3
OG0011985	3	0	0	0	3
OG0011986	3	0	0	0	3
OG0011987	3	0	0	0	3
OG0011988	2	0	0	1	3
OG0011989	3	0	0	0	3
OG0011990	2	0	0	1	3
OG0011991	3	0	0	0	3
OG0011992	3	0	0	0	3
OG0011993	1	2	0	0	3
OG0011994	1	0	0	2	3
OG0011995	3	0	0	0	3
OG0011996	1	0	0	2	3
OG0011997	3	0	0	0	3
OG0011998	3	0	0	0	3
OG0011999	2	0	0	1	3
OG0012000	3	0	0	0	3
OG0012001	3	0	0	0	3
OG0012002	2	0	0	1	3
OG0012003	2	0	0	1	3
OG0012004	2	0	0	1	3
OG0012005	1	2	0	0	3
OG0012006	3	0	0	0	3
OG0012007	1	0	0	2	3
OG0012008	3	0	0	0	3
OG0012009	3	0	0	0	3
OG0012010	3	0	0	0	3
OG0012011	3	0	0	0	3
OG0012012	1	1	0	1	3
OG0012013	1	0	0	2	3
OG0012014	3	0	0	0	3
OG0012015	3	0	0	0	3
OG0012016	3	0	0	0	3
OG0012017	2	1	0	0	3
OG0012018	3	0	0	0	3
OG0012019	2	1	0	0	3
OG0012020	2	0	0	1	3
OG0012021	2	0	0	1	3
OG0012022	3	0	0	0	3
OG0012023	3	0	0	0	3
OG0012024	1	0	0	2	3
OG0012025	3	0	0	0	3
OG0012026	2	0	0	1	3
OG0012027	3	0	0	0	3
OG0012028	3	0	0	0	3
OG0012029	3	0	0	0	3
OG0012030	1	0	0	2	3
OG0012031	1	0	0	2	3
OG0012032	3	0	0	0	3
OG0012033	1	0	0	2	3
OG0012034	3	0	0	0	3
OG0012035	3	0	0	0	3
OG0012036	3	0	0	0	3
OG0012037	3	0	0	0	3
OG0012038	2	0	0	1	3
OG0012039	3	0	0	0	3
OG0012040	3	0	0	0	3
OG0012041	1	1	0	1	3
OG0012042	3	0	0	0	3
OG0012043	2	1	0	0	3
OG0012044	3	0	0	0	3
OG0012045	3	0	0	0	3
OG0012046	3	0	0	0	3
OG0012047	3	0	0	0	3
OG0012048	3	0	0	0	3
OG0012049	3	0	0	0	3
OG0012050	3	0	0	0	3
OG0012051	3	0	0	0	3
OG0012052	3	0	0	0	3
OG0012053	2	0	0	1	3
OG0012054	2	0	0	1	3
OG0012055	3	0	0	0	3
OG0012056	3	0	0	0	3
OG0012057	3	0	0	0	3
OG0012058	2	0	0	1	3
OG0012059	2	0	0	1	3
OG0012060	2	0	0	1	3
OG0012061	3	0	0	0	3
OG0012062	3	0	0	0	3
OG0012063	2	0	0	1	3
OG0012064	3	0	0	0	3
OG0012065	2	0	1	0	3
OG0012066	1	2	0	0	3
OG0012067	2	0	0	1	3
OG0012068	3	0	0	0	3
OG0012069	2	0	0	1	3
OG0012070	3	0	0	0	3
OG0012071	3	0	0	0	3
OG0012072	3	0	0	0	3
OG0012073	2	0	0	1	3
OG0012074	3	0	0	0	3
OG0012075	3	0	0	0	3
OG0012076	3	0	0	0	3
OG0012077	1	0	0	2	3
OG0012078	1	0	0	2	3
OG0012079	1	0	0	2	3
OG0012080	2	0	0	1	3
OG0012081	3	0	0	0	3
OG0012082	3	0	0	0	3
OG0012083	2	0	0	1	3
OG0012084	2	0	0	1	3
OG0012085	3	0	0	0	3
OG0012086	3	0	0	0	3
OG0012087	3	0	0	0	3
OG0012088	3	0	0	0	3
OG0012089	2	1	0	0	3
OG0012090	1	0	0	2	3
OG0012091	2	0	0	1	3
OG0012092	3	0	0	0	3
OG0012093	3	0	0	0	3
OG0012094	2	0	0	1	3
OG0012095	3	0	0	0	3
OG0012096	2	0	0	1	3
OG0012097	1	1	0	1	3
OG0012098	3	0	0	0	3
OG0012099	3	0	0	0	3
OG0012100	3	0	0	0	3
OG0012101	1	0	0	2	3
OG0012102	2	0	0	1	3
OG0012103	2	0	0	1	3
OG0012104	3	0	0	0	3
OG0012105	3	0	0	0	3
OG0012106	3	0	0	0	3
OG0012107	2	0	0	1	3
OG0012108	2	0	0	1	3
OG0012109	3	0	0	0	3
OG0012110	3	0	0	0	3
OG0012111	3	0	0	0	3
OG0012112	2	0	0	1	3
OG0012113	3	0	0	0	3
OG0012114	3	0	0	0	3
OG0012115	3	0	0	0	3
OG0012116	3	0	0	0	3
OG0012117	3	0	0	0	3
OG0012118	2	0	0	1	3
OG0012119	3	0	0	0	3
OG0012120	3	0	0	0	3
OG0012121	3	0	0	0	3
OG0012122	3	0	0	0	3
OG0012123	3	0	0	0	3
OG0012124	3	0	0	0	3
OG0012125	2	0	0	1	3
OG0012126	2	0	0	1	3
OG0012127	2	0	0	1	3
OG0012128	2	1	0	0	3
OG0012129	2	0	0	1	3
OG0012130	2	0	0	1	3
OG0012131	3	0	0	0	3
OG0012132	3	0	0	0	3
OG0012133	3	0	0	0	3
OG0012134	1	2	0	0	3
OG0012135	3	0	0	0	3
OG0012136	3	0	0	0	3
OG0012137	2	0	0	1	3
OG0012138	3	0	0	0	3
OG0012139	2	0	0	1	3
OG0012140	3	0	0	0	3
OG0012141	3	0	0	0	3
OG0012142	2	0	0	1	3
OG0012143	2	0	0	1	3
OG0012144	3	0	0	0	3
OG0012145	3	0	0	0	3
OG0012146	3	0	0	0	3
OG0012147	2	0	0	1	3
OG0012148	3	0	0	0	3
OG0012149	1	0	0	2	3
OG0012150	2	0	0	1	3
OG0012151	2	0	0	1	3
OG0012152	3	0	0	0	3
OG0012153	3	0	0	0	3
OG0012154	2	0	0	1	3
OG0012155	3	0	0	0	3
OG0012156	2	0	0	1	3
OG0012157	3	0	0	0	3
OG0012158	3	0	0	0	3
OG0012159	3	0	0	0	3
OG0012160	2	0	0	1	3
OG0012161	3	0	0	0	3
OG0012162	3	0	0	0	3
OG0012163	2	0	0	1	3
OG0012164	2	0	0	1	3
OG0012165	3	0	0	0	3
OG0012166	2	0	0	1	3
OG0012167	3	0	0	0	3
OG0012168	2	0	0	1	3
OG0012169	2	0	0	1	3
OG0012170	3	0	0	0	3
OG0012171	2	0	0	1	3
OG0012172	2	0	0	1	3
OG0012173	2	0	0	1	3
OG0012174	3	0	0	0	3
OG0012175	2	1	0	0	3
OG0012176	3	0	0	0	3
OG0012177	2	0	0	1	3
OG0012178	2	0	0	1	3
OG0012179	1	0	0	2	3
OG0012180	2	0	0	1	3
OG0012181	2	0	0	1	3
OG0012182	1	0	0	2	3
OG0012183	3	0	0	0	3
OG0012184	3	0	0	0	3
OG0012185	2	0	0	1	3
OG0012186	1	0	0	2	3
OG0012187	3	0	0	0	3
OG0012188	3	0	0	0	3
OG0012189	3	0	0	0	3
OG0012190	3	0	0	0	3
OG0012191	3	0	0	0	3
OG0012192	3	0	0	0	3
OG0012193	2	0	0	1	3
OG0012194	3	0	0	0	3
OG0012195	3	0	0	0	3
OG0012196	2	0	0	1	3
OG0012197	1	0	0	2	3
OG0012198	3	0	0	0	3
OG0012199	3	0	0	0	3
OG0012200	3	0	0	0	3
OG0012201	3	0	0	0	3
OG0012202	2	0	0	1	3
OG0012203	3	0	0	0	3
OG0012204	3	0	0	0	3
OG0012205	3	0	0	0	3
OG0012206	3	0	0	0	3
OG0012207	1	0	0	2	3
OG0012208	2	0	0	1	3
OG0012209	3	0	0	0	3
OG0012210	3	0	0	0	3
OG0012211	2	0	0	1	3
OG0012212	3	0	0	0	3
OG0012213	2	0	0	1	3
OG0012214	2	0	0	1	3
OG0012215	2	0	0	1	3
OG0012216	1	0	0	2	3
OG0012217	3	0	0	0	3
OG0012218	3	0	0	0	3
OG0012219	3	0	0	0	3
OG0012220	1	0	0	2	3
OG0012221	3	0	0	0	3
OG0012222	3	0	0	0	3
OG0012223	3	0	0	0	3
OG0012224	2	0	0	1	3
OG0012225	2	0	0	1	3
OG0012226	3	0	0	0	3
OG0012227	2	0	0	1	3
OG0012228	2	0	0	1	3
OG0012229	2	0	0	1	3
OG0012230	3	0	0	0	3
OG0012231	2	0	0	1	3
OG0012232	1	0	0	2	3
OG0012233	2	0	0	1	3
OG0012234	2	0	0	1	3
OG0012235	3	0	0	0	3
OG0012236	2	0	0	1	3
OG0012237	3	0	0	0	3
OG0012238	2	0	0	1	3
OG0012239	3	0	0	0	3
OG0012240	1	0	0	2	3
OG0012241	3	0	0	0	3
OG0012242	3	0	0	0	3
OG0012243	3	0	0	0	3
OG0012244	2	0	0	1	3
OG0012245	1	0	0	2	3
OG0012246	3	0	0	0	3
OG0012247	3	0	0	0	3
OG0012248	2	0	0	1	3
OG0012249	3	0	0	0	3
OG0012250	3	0	0	0	3
OG0012251	3	0	0	0	3
OG0012252	2	0	0	1	3
OG0012253	1	0	0	2	3
OG0012254	2	0	0	1	3
OG0012255	3	0	0	0	3
OG0012256	3	0	0	0	3
OG0012257	2	1	0	0	3
OG0012258	3	0	0	0	3
OG0012259	2	0	0	1	3
OG0012260	3	0	0	0	3
OG0012261	2	0	0	1	3
OG0012262	3	0	0	0	3
OG0012263	3	0	0	0	3
OG0012264	2	0	0	1	3
OG0012265	3	0	0	0	3
OG0012266	3	0	0	0	3
OG0012267	2	0	0	1	3
OG0012268	3	0	0	0	3
OG0012269	2	0	0	1	3
OG0012270	1	0	0	2	3
OG0012271	2	1	0	0	3
OG0012272	3	0	0	0	3
OG0012273	3	0	0	0	3
OG0012274	2	0	0	1	3
OG0012275	3	0	0	0	3
OG0012276	3	0	0	0	3
OG0012277	1	0	0	2	3
OG0012278	2	0	0	1	3
OG0012279	3	0	0	0	3
OG0012280	2	0	0	1	3
OG0012281	1	0	0	2	3
OG0012282	3	0	0	0	3
OG0012283	3	0	0	0	3
OG0012284	3	0	0	0	3
OG0012285	3	0	0	0	3
OG0012286	2	0	0	1	3
OG0012287	1	0	0	2	3
OG0012288	3	0	0	0	3
OG0012289	3	0	0	0	3
OG0012290	3	0	0	0	3
OG0012291	3	0	0	0	3
OG0012292	2	0	0	1	3
OG0012293	3	0	0	0	3
OG0012294	3	0	0	0	3
OG0012295	3	0	0	0	3
OG0012296	1	0	0	2	3
OG0012297	2	0	0	1	3
OG0012298	3	0	0	0	3
OG0012299	3	0	0	0	3
OG0012300	1	0	0	2	3
OG0012301	3	0	0	0	3
OG0012302	3	0	0	0	3
OG0012303	3	0	0	0	3
OG0012304	1	0	0	2	3
OG0012305	3	0	0	0	3
OG0012306	3	0	0	0	3
OG0012307	2	0	0	1	3
OG0012308	3	0	0	0	3
OG0012309	3	0	0	0	3
OG0012310	2	0	0	1	3
OG0012311	2	0	0	1	3
OG0012312	1	0	0	2	3
OG0012313	3	0	0	0	3
OG0012314	3	0	0	0	3
OG0012315	1	0	0	2	3
OG0012316	2	0	0	1	3
OG0012317	2	0	0	1	3
OG0012318	2	0	0	1	3
OG0012319	2	0	0	1	3
OG0012320	2	0	0	1	3
OG0012321	2	0	0	1	3
OG0012322	3	0	0	0	3
OG0012323	1	0	0	2	3
OG0012324	2	0	0	1	3
OG0012325	3	0	0	0	3
OG0012326	2	1	0	0	3
OG0012327	1	0	0	2	3
OG0012328	2	0	0	1	3
OG0012329	3	0	0	0	3
OG0012330	2	0	0	1	3
OG0012331	3	0	0	0	3
OG0012332	2	0	0	1	3
OG0012333	2	0	0	1	3
OG0012334	2	1	0	0	3
OG0012335	3	0	0	0	3
OG0012336	3	0	0	0	3
OG0012337	3	0	0	0	3
OG0012338	3	0	0	0	3
OG0012339	1	2	0	0	3
OG0012340	3	0	0	0	3
OG0012341	1	0	0	2	3
OG0012342	3	0	0	0	3
OG0012343	1	0	0	2	3
OG0012344	3	0	0	0	3
OG0012345	3	0	0	0	3
OG0012346	3	0	0	0	3
OG0012347	3	0	0	0	3
OG0012348	3	0	0	0	3
OG0012349	1	0	0	2	3
OG0012350	3	0	0	0	3
OG0012351	3	0	0	0	3
OG0012352	1	0	0	2	3
OG0012353	3	0	0	0	3
OG0012354	3	0	0	0	3
OG0012355	2	1	0	0	3
OG0012356	3	0	0	0	3
OG0012357	2	0	0	1	3
OG0012358	1	0	0	2	3
OG0012359	3	0	0	0	3
OG0012360	3	0	0	0	3
OG0012361	3	0	0	0	3
OG0012362	3	0	0	0	3
OG0012363	3	0	0	0	3
OG0012364	3	0	0	0	3
OG0012365	2	0	0	1	3
OG0012366	2	0	0	1	3
OG0012367	3	0	0	0	3
OG0012368	1	0	0	2	3
OG0012369	2	0	0	1	3
OG0012370	3	0	0	0	3
OG0012371	3	0	0	0	3
OG0012372	1	0	0	2	3
OG0012373	1	1	0	1	3
OG0012374	3	0	0	0	3
OG0012375	1	0	0	2	3
OG0012376	3	0	0	0	3
OG0012377	3	0	0	0	3
OG0012378	1	1	0	1	3
OG0012379	3	0	0	0	3
OG0012380	2	0	0	1	3
OG0012381	3	0	0	0	3
OG0012382	3	0	0	0	3
OG0012383	2	0	0	1	3
OG0012384	2	0	0	1	3
OG0012385	3	0	0	0	3
OG0012386	2	1	0	0	3
OG0012387	3	0	0	0	3
OG0012388	3	0	0	0	3
OG0012389	1	0	0	2	3
OG0012390	3	0	0	0	3
OG0012391	2	1	0	0	3
OG0012392	1	1	0	1	3
OG0012393	2	0	0	1	3
OG0012394	3	0	0	0	3
OG0012395	1	0	1	1	3
OG0012396	3	0	0	0	3
OG0012397	2	0	0	1	3
OG0012398	3	0	0	0	3
OG0012399	3	0	0	0	3
OG0012400	3	0	0	0	3
OG0012401	3	0	0	0	3
OG0012402	3	0	0	0	3
OG0012403	3	0	0	0	3
OG0012404	2	0	0	1	3
OG0012405	2	0	0	1	3
OG0012406	2	0	0	1	3
OG0012407	1	0	0	2	3
OG0012408	2	0	0	1	3
OG0012409	3	0	0	0	3
OG0012410	3	0	0	0	3
OG0012411	3	0	0	0	3
OG0012412	3	0	0	0	3
OG0012413	3	0	0	0	3
OG0012414	3	0	0	0	3
OG0012415	1	1	0	1	3
OG0012416	3	0	0	0	3
OG0012417	2	0	0	1	3
OG0012418	3	0	0	0	3
OG0012419	3	0	0	0	3
OG0012420	3	0	0	0	3
OG0012421	2	0	0	1	3
OG0012422	3	0	0	0	3
OG0012423	3	0	0	0	3
OG0012424	2	0	0	1	3
OG0012425	3	0	0	0	3
OG0012426	1	0	0	2	3
OG0012427	1	0	0	2	3
OG0012428	2	0	0	1	3
OG0012429	2	0	0	1	3
OG0012430	3	0	0	0	3
OG0012431	3	0	0	0	3
OG0012432	3	0	0	0	3
OG0012433	1	0	0	2	3
OG0012434	2	0	0	1	3
OG0012435	3	0	0	0	3
OG0012436	3	0	0	0	3
OG0012437	3	0	0	0	3
OG0012438	1	0	0	2	3
OG0012439	2	0	0	1	3
OG0012440	2	0	0	1	3
OG0012441	1	0	0	2	3
OG0012442	1	1	0	1	3
OG0012443	2	0	0	1	3
OG0012444	2	0	0	1	3
OG0012445	1	0	1	1	3
OG0012446	3	0	0	0	3
OG0012447	2	0	0	1	3
OG0012448	2	0	0	1	3
OG0012449	3	0	0	0	3
OG0012450	1	0	0	2	3
OG0012451	1	1	0	1	3
OG0012452	1	1	0	1	3
OG0012453	3	0	0	0	3
OG0012454	1	0	1	1	3
OG0012455	1	1	0	1	3
OG0012456	3	0	0	0	3
OG0012457	3	0	0	0	3
OG0012458	2	0	0	1	3
OG0012459	2	0	0	1	3
OG0012460	3	0	0	0	3
OG0012461	3	0	0	0	3
OG0012462	2	0	0	1	3
OG0012463	3	0	0	0	3
OG0012464	3	0	0	0	3
OG0012465	1	1	0	1	3
OG0012466	1	0	0	2	3
OG0012467	2	0	0	1	3
OG0012468	2	0	0	1	3
OG0012469	3	0	0	0	3
OG0012470	3	0	0	0	3
OG0012471	1	0	0	2	3
OG0012472	1	0	1	1	3
OG0012473	1	0	1	1	3
OG0012474	3	0	0	0	3
OG0012475	2	1	0	0	3
OG0012476	1	0	0	2	3
OG0012477	1	0	1	1	3
OG0012478	3	0	0	0	3
OG0012479	1	0	1	1	3
OG0012480	3	0	0	0	3
OG0012481	3	0	0	0	3
OG0012482	1	0	1	1	3
OG0012483	1	1	0	1	3
OG0012484	3	0	0	0	3
OG0012485	3	0	0	0	3
OG0012486	1	1	0	1	3
OG0012487	1	0	1	1	3
OG0012488	1	0	1	1	3
OG0012489	3	0	0	0	3
OG0012490	2	0	0	1	3
OG0012491	1	2	0	0	3
OG0012492	2	1	0	0	3
OG0012493	2	0	0	1	3
OG0012494	3	0	0	0	3
OG0012495	3	0	0	0	3
OG0012496	3	0	0	0	3
OG0012497	1	1	0	1	3
OG0012498	3	0	0	0	3
OG0012499	2	0	0	1	3
OG0012500	3	0	0	0	3
OG0012501	3	0	0	0	3
OG0012502	3	0	0	0	3
OG0012503	1	1	0	1	3
OG0012504	2	0	0	1	3
OG0012505	1	0	1	1	3
OG0012506	2	0	0	1	3
OG0012507	1	1	0	1	3
OG0012508	1	0	1	1	3
OG0012509	1	0	2	0	3
OG0012510	3	0	0	0	3
OG0012511	1	0	0	2	3
OG0012512	1	0	1	1	3
OG0012513	1	0	0	2	3
OG0012514	3	0	0	0	3
OG0012515	1	0	0	2	3
OG0012516	3	0	0	0	3
OG0012517	1	0	0	2	3
OG0012518	3	0	0	0	3
OG0012519	1	0	1	1	3
OG0012520	1	0	0	2	3
OG0012521	3	0	0	0	3
OG0012522	2	0	0	1	3
OG0012523	1	0	0	2	3
OG0012524	3	0	0	0	3
OG0012525	3	0	0	0	3
OG0012526	2	0	0	1	3
OG0012527	3	0	0	0	3
OG0012528	3	0	0	0	3
OG0012529	2	0	0	1	3
OG0012530	3	0	0	0	3
OG0012531	3	0	0	0	3
OG0012532	3	0	0	0	3
OG0012533	3	0	0	0	3
OG0012534	2	0	0	1	3
OG0012535	1	0	0	2	3
OG0012536	1	0	0	2	3
OG0012537	3	0	0	0	3
OG0012538	1	0	1	1	3
OG0012539	3	0	0	0	3
OG0012540	3	0	0	0	3
OG0012541	1	2	0	0	3
OG0012542	1	1	0	1	3
OG0012543	1	0	0	2	3
OG0012544	1	1	0	1	3
OG0012545	3	0	0	0	3
OG0012546	3	0	0	0	3
OG0012547	2	0	0	1	3
OG0012548	3	0	0	0	3
OG0012549	1	0	1	1	3
OG0012550	1	1	0	1	3
OG0012551	3	0	0	0	3
OG0012552	1	0	0	2	3
OG0012553	2	0	0	1	3
OG0012554	3	0	0	0	3
OG0012555	3	0	0	0	3
OG0012556	3	0	0	0	3
OG0012557	1	0	1	1	3
OG0012558	2	0	0	1	3
OG0012559	3	0	0	0	3
OG0012560	2	0	0	1	3
OG0012561	1	0	0	2	3
OG0012562	1	0	1	1	3
OG0012563	1	0	1	1	3
OG0012564	1	1	0	1	3
OG0012565	1	0	1	1	3
OG0012566	1	0	0	2	3
OG0012567	3	0	0	0	3
OG0012568	1	0	0	2	3
OG0012569	1	0	1	1	3
OG0012570	2	1	0	0	3
OG0012571	2	0	0	1	3
OG0012572	1	0	0	2	3
OG0012573	1	0	1	1	3
OG0012574	3	0	0	0	3
OG0012575	3	0	0	0	3
OG0012576	2	0	0	1	3
OG0012577	1	1	0	1	3
OG0012578	3	0	0	0	3
OG0012579	1	1	0	1	3
OG0012580	1	0	0	2	3
OG0012581	1	0	1	1	3
OG0012582	1	0	1	1	3
OG0012583	1	0	0	2	3
OG0012584	2	0	0	1	3
OG0012585	1	0	1	1	3
OG0012586	1	1	0	1	3
OG0012587	2	1	0	0	3
OG0012588	1	1	0	1	3
OG0012589	1	0	1	1	3
OG0012590	1	0	0	2	3
OG0012591	1	1	0	1	3
OG0012592	3	0	0	0	3
OG0012593	1	0	0	2	3
OG0012594	2	0	0	1	3
OG0012595	1	0	0	2	3
OG0012596	3	0	0	0	3
OG0012597	3	0	0	0	3
OG0012598	2	0	0	1	3
OG0012599	3	0	0	0	3
OG0012600	1	1	0	1	3
OG0012601	1	0	1	1	3
OG0012602	3	0	0	0	3
OG0012603	2	0	0	1	3
OG0012604	2	0	0	1	3
OG0012605	2	1	0	0	3
OG0012606	1	0	0	2	3
OG0012607	3	0	0	0	3
OG0012608	1	1	0	1	3
OG0012609	1	1	0	1	3
OG0012610	1	0	0	2	3
OG0012611	2	0	0	1	3
OG0012612	1	0	1	1	3
OG0012613	1	0	0	2	3
OG0012614	1	1	0	1	3
OG0012615	1	0	0	2	3
OG0012616	1	0	0	2	3
OG0012617	2	0	0	1	3
OG0012618	1	1	0	1	3
OG0012619	3	0	0	0	3
OG0012620	1	1	0	1	3
OG0012621	2	0	0	1	3
OG0012622	2	0	0	1	3
OG0012623	2	0	0	1	3
OG0012624	1	0	1	1	3
OG0012625	1	0	0	2	3
OG0012626	2	0	0	1	3
OG0012627	1	2	0	0	3
OG0012628	1	0	0	2	3
OG0012629	3	0	0	0	3
OG0012630	2	0	0	1	3
OG0012631	2	1	0	0	3
OG0012632	1	1	0	1	3
OG0012633	1	0	0	2	3
OG0012634	2	1	0	0	3
OG0012635	1	0	0	2	3
OG0012636	1	0	0	2	3
OG0012637	1	1	0	1	3
OG0012638	2	0	0	1	3
OG0012639	2	0	0	1	3
OG0012640	1	0	0	2	3
OG0012641	1	0	0	2	3
OG0012642	2	0	0	1	3
OG0012643	1	0	0	2	3
OG0012644	3	0	0	0	3
OG0012645	1	0	1	1	3
OG0012646	1	1	0	1	3
OG0012647	2	0	0	1	3
OG0012648	1	0	0	2	3
OG0012649	1	0	1	1	3
OG0012650	1	0	0	2	3
OG0012651	2	0	0	1	3
OG0012652	1	0	1	1	3
OG0012653	1	0	1	1	3
OG0012654	1	0	1	1	3
OG0012655	1	0	0	2	3
OG0012656	3	0	0	0	3
OG0012657	1	0	0	2	3
OG0012658	1	0	1	1	3
OG0012659	1	0	0	2	3
OG0012660	1	0	0	2	3
OG0012661	1	1	0	1	3
OG0012662	1	1	0	1	3
OG0012663	3	0	0	0	3
OG0012664	1	0	0	2	3
OG0012665	3	0	0	0	3
OG0012666	1	0	0	2	3
OG0012667	1	0	0	2	3
OG0012668	1	0	1	1	3
OG0012669	2	0	0	1	3
OG0012670	3	0	0	0	3
OG0012671	2	0	0	1	3
OG0012672	3	0	0	0	3
OG0012673	3	0	0	0	3
OG0012674	1	1	0	1	3
OG0012675	1	0	0	2	3
OG0012676	1	1	0	1	3
OG0012677	2	0	0	1	3
OG0012678	1	1	0	1	3
OG0012679	1	0	0	2	3
OG0012680	1	0	0	2	3
OG0012681	1	1	0	1	3
OG0012682	2	0	0	1	3
OG0012683	1	0	1	1	3
OG0012684	3	0	0	0	3
OG0012685	3	0	0	0	3
OG0012686	1	0	0	2	3
OG0012687	1	2	0	0	3
OG0012688	1	0	0	2	3
OG0012689	2	1	0	0	3
OG0012690	2	0	0	1	3
OG0012691	1	0	0	2	3
OG0012692	1	0	1	1	3
OG0012693	3	0	0	0	3
OG0012694	1	1	0	1	3
OG0012695	1	0	1	1	3
OG0012696	1	1	0	1	3
OG0012697	1	1	0	1	3
OG0012698	3	0	0	0	3
OG0012699	1	0	1	1	3
OG0012700	1	2	0	0	3
OG0012701	1	0	1	1	3
OG0012702	3	0	0	0	3
OG0012703	1	1	0	1	3
OG0012704	1	0	1	1	3
OG0012705	1	0	1	1	3
OG0012706	1	0	1	1	3
OG0012707	1	0	1	1	3
OG0012708	1	0	0	2	3
OG0012709	1	0	1	1	3
OG0012710	1	0	0	2	3
OG0012711	1	1	0	1	3
OG0012712	1	1	0	1	3
OG0012713	1	0	1	1	3
OG0012714	1	0	1	1	3
OG0012715	1	0	1	1	3
OG0012716	2	0	0	1	3
OG0012717	1	0	1	1	3
OG0012718	1	0	1	1	3
OG0012719	1	0	1	1	3
OG0012720	3	0	0	0	3
OG0012721	1	0	1	1	3
OG0012722	1	0	1	1	3
OG0012723	2	1	0	0	3
OG0012724	1	1	0	1	3
OG0012725	1	0	0	2	3
OG0012726	3	0	0	0	3
OG0012727	2	1	0	0	3
OG0012728	3	0	0	0	3
OG0012729	1	0	1	1	3
OG0012730	1	1	0	1	3
OG0012731	1	1	0	1	3
OG0012732	1	0	1	1	3
OG0012733	1	1	0	1	3
OG0012734	1	1	1	0	3
OG0012735	1	1	0	1	3
OG0012736	1	1	0	1	3
OG0012737	3	0	0	0	3
OG0012738	1	1	0	1	3
OG0012739	1	1	0	1	3
OG0012740	2	0	0	1	3
OG0012741	2	0	0	1	3
OG0012742	3	0	0	0	3
OG0012743	1	0	0	2	3
OG0012744	3	0	0	0	3
OG0012745	1	0	1	1	3
OG0012746	1	1	0	1	3
OG0012747	1	0	0	2	3
OG0012748	1	0	1	1	3
OG0012749	1	0	0	2	3
OG0012750	2	1	0	0	3
OG0012751	1	1	0	1	3
OG0012752	1	0	1	1	3
OG0012753	1	0	0	2	3
OG0012754	1	0	0	2	3
OG0012755	1	1	0	1	3
OG0012756	1	1	0	1	3
OG0012757	1	0	0	2	3
OG0012758	1	1	0	1	3
OG0012759	1	0	0	2	3
OG0012760	1	0	0	2	3
OG0012761	1	0	1	1	3
OG0012762	1	0	0	2	3
OG0012763	1	0	0	2	3
OG0012764	1	1	0	1	3
OG0012765	1	1	0	1	3
OG0012766	1	0	1	1	3
OG0012767	1	1	1	0	3
OG0012768	1	1	0	1	3
OG0012769	1	1	0	1	3
OG0012770	1	0	0	2	3
OG0012771	1	1	0	1	3
OG0012772	1	0	0	2	3
OG0012773	1	1	0	1	3
OG0012774	1	0	0	2	3
OG0012775	1	0	0	2	3
OG0012776	1	0	0	2	3
OG0012777	1	1	0	1	3
OG0012778	1	0	1	1	3
OG0012779	1	0	0	2	3
OG0012780	1	0	0	2	3
OG0012781	1	1	0	1	3
OG0012782	1	0	1	1	3
OG0012783	1	1	0	1	3
OG0012784	1	0	1	1	3
OG0012785	1	0	1	1	3
OG0012786	1	0	1	1	3
OG0012787	3	0	0	0	3
OG0012788	2	0	0	1	3
OG0012789	1	0	0	2	3
OG0012790	3	0	0	0	3
OG0012791	1	1	0	1	3
OG0012792	1	1	0	1	3
OG0012793	1	0	1	1	3
OG0012794	3	0	0	0	3
OG0012795	3	0	0	0	3
OG0012796	1	0	0	2	3
OG0012797	2	0	0	1	3
OG0012798	3	0	0	0	3
OG0012799	1	0	0	2	3
OG0012800	1	1	0	1	3
OG0012801	1	2	0	0	3
OG0012802	1	1	1	0	3
OG0012803	2	0	0	1	3
OG0012804	1	0	0	2	3
OG0012805	1	1	0	1	3
OG0012806	1	1	1	0	3
OG0012807	1	1	0	1	3
OG0012808	1	0	0	2	3
OG0012809	1	1	1	0	3
OG0012810	1	0	0	2	3
OG0012811	1	0	1	1	3
OG0012812	3	0	0	0	3
OG0012813	1	0	0	2	3
OG0012814	3	0	0	0	3
OG0012815	3	0	0	0	3
OG0012816	1	0	1	1	3
OG0012817	3	0	0	0	3
OG0012818	3	0	0	0	3
OG0012819	1	1	0	1	3
OG0012820	1	1	1	0	3
OG0012821	2	0	0	1	3
OG0012822	1	0	1	1	3
OG0012823	1	0	0	2	3
OG0012824	1	0	1	1	3
OG0012825	1	0	0	2	3
OG0012826	2	0	0	1	3
OG0012827	1	0	0	2	3
OG0012828	1	0	1	1	3
OG0012829	1	0	1	1	3
OG0012830	3	0	0	0	3
OG0012831	3	0	0	0	3
OG0012832	1	1	0	1	3
OG0012833	1	1	0	1	3
OG0012834	1	0	0	2	3
OG0012835	3	0	0	0	3
OG0012836	1	0	1	1	3
OG0012837	2	0	0	1	3
OG0012838	3	0	0	0	3
OG0012839	1	0	0	2	3
OG0012840	1	0	0	2	3
OG0012841	1	0	1	1	3
OG0012842	1	0	0	2	3
OG0012843	1	0	0	2	3
OG0012844	1	0	0	2	3
OG0012845	1	0	0	2	3
OG0012846	1	1	0	1	3
OG0012847	1	0	1	1	3
OG0012848	1	0	0	2	3
OG0012849	3	0	0	0	3
OG0012850	1	1	0	1	3
OG0012851	1	2	0	0	3
OG0012852	1	1	0	1	3
OG0012853	1	0	0	2	3
OG0012854	1	0	1	1	3
OG0012855	1	0	0	2	3
OG0012856	3	0	0	0	3
OG0012857	2	0	0	1	3
OG0012858	1	1	0	1	3
OG0012859	1	0	0	2	3
OG0012860	1	0	0	2	3
OG0012861	1	1	0	1	3
OG0012862	3	0	0	0	3
OG0012863	1	0	0	2	3
OG0012864	1	1	0	1	3
OG0012865	1	1	0	1	3
OG0012866	3	0	0	0	3
OG0012867	2	0	0	1	3
OG0012868	1	1	0	1	3
OG0012869	1	0	0	2	3
OG0012870	3	0	0	0	3
OG0012871	1	0	0	2	3
OG0012872	1	0	0	2	3
OG0012873	1	1	0	1	3
OG0012874	2	0	0	1	3
OG0012875	1	0	0	2	3
OG0012876	3	0	0	0	3
OG0012877	1	0	1	1	3
OG0012878	1	0	1	1	3
OG0012879	1	1	0	1	3
OG0012880	1	1	0	1	3
OG0012881	1	2	0	0	3
OG0012882	1	1	0	1	3
OG0012883	1	0	0	2	3
OG0012884	1	0	0	2	3
OG0012885	3	0	0	0	3
OG0012886	1	1	0	1	3
OG0012887	2	1	0	0	3
OG0012888	1	0	0	2	3
OG0012889	1	1	0	1	3
OG0012890	3	0	0	0	3
OG0012891	1	0	1	1	3
OG0012892	1	0	1	1	3
OG0012893	1	0	0	2	3
OG0012894	3	0	0	0	3
OG0012895	3	0	0	0	3
OG0012896	1	0	0	2	3
OG0012897	1	1	0	1	3
OG0012898	1	1	0	1	3
OG0012899	1	0	1	1	3
OG0012900	2	0	0	1	3
OG0012901	1	0	0	2	3
OG0012902	1	0	0	2	3
OG0012903	1	0	0	2	3
OG0012904	1	0	0	2	3
OG0012905	1	0	1	1	3
OG0012906	1	1	0	1	3
OG0012907	1	0	1	1	3
OG0012908	1	1	0	1	3
OG0012909	1	0	0	2	3
OG0012910	1	0	0	2	3
OG0012911	1	1	1	0	3
OG0012912	1	0	0	2	3
OG0012913	1	1	0	1	3
OG0012914	2	0	0	1	3
OG0012915	1	0	0	2	3
OG0012916	1	0	0	2	3
OG0012917	3	0	0	0	3
OG0012918	3	0	0	0	3
OG0012919	3	0	0	0	3
OG0012920	2	0	0	1	3
OG0012921	1	1	0	1	3
OG0012922	1	0	0	2	3
OG0012923	1	0	0	2	3
OG0012924	1	1	0	1	3
OG0012925	1	1	0	1	3
OG0012926	1	0	0	2	3
OG0012927	1	1	0	1	3
OG0012928	1	0	1	1	3
OG0012929	1	0	0	2	3
OG0012930	1	1	0	1	3
OG0012931	1	1	0	1	3
OG0012932	2	0	0	1	3
OG0012933	1	0	1	1	3
OG0012934	1	0	1	1	3
OG0012935	1	0	1	1	3
OG0012936	1	0	1	1	3
OG0012937	1	0	1	1	3
OG0012938	1	0	0	2	3
OG0012939	1	0	0	2	3
OG0012940	1	0	1	1	3
OG0012941	1	1	0	1	3
OG0012942	1	0	1	1	3
OG0012943	1	1	0	1	3
OG0012944	1	2	0	0	3
OG0012945	1	0	0	2	3
OG0012946	1	0	1	1	3
OG0012947	1	0	0	2	3
OG0012948	3	0	0	0	3
OG0012949	1	1	0	1	3
OG0012950	1	0	0	2	3
OG0012951	1	0	1	1	3
OG0012952	1	1	0	1	3
OG0012953	1	0	0	2	3
OG0012954	2	0	0	1	3
OG0012955	1	0	1	1	3
OG0012956	1	1	0	1	3
OG0012957	1	1	1	0	3
OG0012958	1	0	0	2	3
OG0012959	1	1	0	1	3
OG0012960	1	0	1	1	3
OG0012961	2	0	0	1	3
OG0012962	1	0	1	1	3
OG0012963	2	1	0	0	3
OG0012964	3	0	0	0	3
OG0012965	1	1	0	1	3
OG0012966	1	1	0	1	3
OG0012967	1	1	1	0	3
OG0012968	1	1	0	1	3
OG0012969	1	0	0	2	3
OG0012970	1	0	0	2	3
OG0012971	1	0	1	1	3
OG0012972	1	1	0	1	3
OG0012973	1	1	0	1	3
OG0012974	1	1	0	1	3
OG0012975	2	0	0	1	3
OG0012976	3	0	0	0	3
OG0012977	1	0	0	2	3
OG0012978	1	0	0	2	3
OG0012979	3	0	0	0	3
OG0012980	1	0	1	1	3
OG0012981	1	1	0	1	3
OG0012982	1	1	0	1	3
OG0012983	1	1	0	1	3
OG0012984	1	0	1	1	3
OG0012985	2	0	0	1	3
OG0012986	1	1	0	1	3
OG0012987	1	0	0	2	3
OG0012988	1	1	0	1	3
OG0012989	1	0	1	1	3
OG0012990	1	2	0	0	3
OG0012991	1	1	0	1	3
OG0012992	1	0	1	1	3
OG0012993	3	0	0	0	3
OG0012994	1	0	1	1	3
OG0012995	1	0	1	1	3
OG0012996	1	0	1	1	3
OG0012997	1	0	1	1	3
OG0012998	1	0	1	1	3
OG0012999	1	1	0	1	3
OG0013000	1	0	1	1	3
OG0013001	1	0	0	2	3
OG0013002	1	0	1	1	3
OG0013003	1	0	1	1	3
OG0013004	2	0	0	1	3
OG0013005	1	1	0	1	3
OG0013006	3	0	0	0	3
OG0013007	1	1	0	1	3
OG0013008	1	1	0	1	3
OG0013009	2	0	0	1	3
OG0013010	1	1	1	0	3
OG0013011	1	0	0	2	3
OG0013012	1	1	0	1	3
OG0013013	1	0	1	1	3
OG0013014	1	0	0	2	3
OG0013015	1	1	0	1	3
OG0013016	1	1	1	0	3
OG0013017	2	0	0	1	3
OG0013018	1	0	1	1	3
OG0013019	3	0	0	0	3
OG0013020	1	1	0	1	3
OG0013021	1	1	0	1	3
OG0013022	3	0	0	0	3
OG0013023	1	0	1	1	3
OG0013024	1	0	0	2	3
OG0013025	1	0	0	2	3
OG0013026	1	0	1	1	3
OG0013027	1	1	0	1	3
OG0013028	1	0	1	1	3
OG0013029	3	0	0	0	3
OG0013030	1	1	0	1	3
OG0013031	1	1	1	0	3
OG0013032	1	0	0	2	3
OG0013033	1	0	1	1	3
OG0013034	1	0	0	2	3
OG0013035	1	0	1	1	3
OG0013036	1	0	0	2	3
OG0013037	1	0	0	2	3
OG0013038	1	0	1	1	3
OG0013039	1	0	1	1	3
OG0013040	1	0	0	2	3
OG0013041	1	0	1	1	3
OG0013042	3	0	0	0	3
OG0013043	1	1	0	1	3
OG0013044	1	0	1	1	3
OG0013045	1	0	1	1	3
OG0013046	1	1	0	1	3
OG0013047	1	0	0	2	3
OG0013048	1	1	0	1	3
OG0013049	3	0	0	0	3
OG0013050	1	0	0	2	3
OG0013051	3	0	0	0	3
OG0013052	1	0	1	1	3
OG0013053	1	1	0	1	3
OG0013054	1	1	0	1	3
OG0013055	1	0	1	1	3
OG0013056	1	0	1	1	3
OG0013057	1	1	0	1	3
OG0013058	1	0	0	2	3
OG0013059	1	0	1	1	3
OG0013060	1	1	0	1	3
OG0013061	1	1	0	1	3
OG0013062	1	1	0	1	3
OG0013063	1	1	0	1	3
OG0013064	1	0	1	1	3
OG0013065	1	0	1	1	3
OG0013066	1	1	0	1	3
OG0013067	1	1	0	1	3
OG0013068	1	0	1	1	3
OG0013069	1	0	0	2	3
OG0013070	1	0	1	1	3
OG0013071	2	0	0	1	3
OG0013072	1	1	0	1	3
OG0013073	1	2	0	0	3
OG0013074	1	1	0	1	3
OG0013075	1	1	0	1	3
OG0013076	1	1	0	1	3
OG0013077	1	1	0	1	3
OG0013078	1	1	0	1	3
OG0013079	1	0	0	2	3
OG0013080	3	0	0	0	3
OG0013081	1	1	0	1	3
OG0013082	1	1	0	1	3
OG0013083	1	0	1	1	3
OG0013084	2	0	1	0	3
OG0013085	2	0	0	1	3
OG0013086	1	1	0	1	3
OG0013087	3	0	0	0	3
OG0013088	1	1	0	1	3
OG0013089	1	0	1	1	3
OG0013090	2	0	0	1	3
OG0013091	1	0	0	2	3
OG0013092	1	0	1	1	3
OG0013093	1	0	1	1	3
OG0013094	1	1	0	1	3
OG0013095	1	0	0	2	3
OG0013096	1	0	1	1	3
OG0013097	1	1	0	1	3
OG0013098	1	0	1	1	3
OG0013099	1	0	1	1	3
OG0013100	1	1	0	1	3
OG0013101	1	1	0	1	3
OG0013102	1	1	0	1	3
OG0013103	1	0	0	2	3
OG0013104	2	0	0	1	3
OG0013105	1	1	0	1	3
OG0013106	1	0	1	1	3
OG0013107	1	0	0	2	3
OG0013108	1	1	0	1	3
OG0013109	1	1	0	1	3
OG0013110	1	1	0	1	3
OG0013111	1	0	1	1	3
OG0013112	2	0	0	1	3
OG0013113	1	0	0	2	3
OG0013114	1	0	1	1	3
OG0013115	1	0	1	1	3
OG0013116	1	1	0	1	3
OG0013117	1	0	1	1	3
OG0013118	2	0	0	1	3
OG0013119	1	1	0	1	3
OG0013120	1	1	0	1	3
OG0013121	1	0	1	1	3
OG0013122	1	2	0	0	3
OG0013123	1	1	0	1	3
OG0013124	3	0	0	0	3
OG0013125	1	0	0	2	3
OG0013126	1	0	0	2	3
OG0013127	1	0	0	2	3
OG0013128	1	0	0	2	3
OG0013129	3	0	0	0	3
OG0013130	1	0	1	1	3
OG0013131	1	1	0	1	3
OG0013132	1	0	1	1	3
OG0013133	1	1	0	1	3
OG0013134	1	0	0	2	3
OG0013135	1	1	0	1	3
OG0013136	1	2	0	0	3
OG0013137	1	0	1	1	3
OG0013138	1	0	1	1	3
OG0013139	1	0	1	1	3
OG0013140	3	0	0	0	3
OG0013141	3	0	0	0	3
OG0013142	1	0	0	2	3
OG0013143	1	1	0	1	3
OG0013144	1	0	0	2	3
OG0013145	1	1	0	1	3
OG0013146	2	0	0	1	3
OG0013147	2	0	0	1	3
OG0013148	1	0	1	1	3
OG0013149	1	1	0	1	3
OG0013150	1	0	1	1	3
OG0013151	1	1	0	1	3
OG0013152	1	0	0	2	3
OG0013153	1	0	0	2	3
OG0013154	1	0	1	1	3
OG0013155	1	0	0	2	3
OG0013156	1	1	0	1	3
OG0013157	1	0	1	1	3
OG0013158	2	0	0	1	3
OG0013159	1	1	0	1	3
OG0013160	3	0	0	0	3
OG0013161	3	0	0	0	3
OG0013162	1	1	0	1	3
OG0013163	2	0	0	1	3
OG0013164	1	0	1	1	3
OG0013165	1	0	0	2	3
OG0013166	1	1	0	1	3
OG0013167	1	0	1	1	3
OG0013168	1	0	0	2	3
OG0013169	1	1	0	1	3
OG0013170	1	0	0	2	3
OG0013171	1	0	1	1	3
OG0013172	1	1	0	1	3
OG0013173	1	0	2	0	3
OG0013174	1	0	0	2	3
OG0013175	1	1	0	1	3
OG0013176	1	1	0	1	3
OG0013177	1	1	0	1	3
OG0013178	1	0	1	1	3
OG0013179	1	0	1	1	3
OG0013180	1	0	1	1	3
OG0013181	1	0	0	2	3
OG0013182	1	0	1	1	3
OG0013183	1	0	1	1	3
OG0013184	1	0	1	1	3
OG0013185	1	1	0	1	3
OG0013186	1	1	0	1	3
OG0013187	2	0	0	1	3
OG0013188	1	0	0	2	3
OG0013189	3	0	0	0	3
OG0013190	3	0	0	0	3
OG0013191	1	1	0	1	3
OG0013192	1	0	1	1	3
OG0013193	1	0	1	1	3
OG0013194	1	0	1	1	3
OG0013195	1	1	0	1	3
OG0013196	1	0	1	1	3
OG0013197	1	0	1	1	3
OG0013198	1	0	1	1	3
OG0013199	1	0	1	1	3
OG0013200	2	0	0	1	3
OG0013201	3	0	0	0	3
OG0013202	1	0	1	1	3
OG0013203	1	1	1	0	3
OG0013204	1	0	0	2	3
OG0013205	1	1	0	1	3
OG0013206	2	0	0	1	3
OG0013207	1	0	1	1	3
OG0013208	1	0	0	2	3
OG0013209	1	1	0	1	3
OG0013210	1	0	1	1	3
OG0013211	1	0	1	1	3
OG0013212	1	0	1	1	3
OG0013213	1	0	0	2	3
OG0013214	1	1	0	1	3
OG0013215	1	0	0	2	3
OG0013216	1	0	0	2	3
OG0013217	2	0	0	1	3
OG0013218	1	0	0	2	3
OG0013219	1	1	0	1	3
OG0013220	1	0	0	2	3
OG0013221	1	1	0	1	3
OG0013222	2	0	0	1	3
OG0013223	1	0	0	2	3
OG0013224	1	0	1	1	3
OG0013225	2	0	0	1	3
OG0013226	3	0	0	0	3
OG0013227	1	1	0	1	3
OG0013228	1	0	1	1	3
OG0013229	1	0	1	1	3
OG0013230	1	0	1	1	3
OG0013231	1	1	0	1	3
OG0013232	1	0	0	2	3
OG0013233	1	0	1	1	3
OG0013234	1	0	0	2	3
OG0013235	1	0	1	1	3
OG0013236	1	1	0	1	3
OG0013237	1	1	0	1	3
OG0013238	1	0	1	1	3
OG0013239	1	0	0	2	3
OG0013240	1	0	1	1	3
OG0013241	2	0	0	1	3
OG0013242	1	1	0	1	3
OG0013243	1	1	0	1	3
OG0013244	1	1	0	1	3
OG0013245	1	1	0	1	3
OG0013246	1	0	1	1	3
OG0013247	1	0	1	1	3
OG0013248	1	0	1	1	3
OG0013249	1	0	1	1	3
OG0013250	1	0	1	1	3
OG0013251	1	0	0	2	3
OG0013252	1	0	0	2	3
OG0013253	2	0	0	1	3
OG0013254	2	0	0	1	3
OG0013255	1	0	1	1	3
OG0013256	1	1	0	1	3
OG0013257	1	1	0	1	3
OG0013258	2	0	0	1	3
OG0013259	1	1	0	1	3
OG0013260	1	1	0	1	3
OG0013261	2	0	0	1	3
OG0013262	1	0	1	1	3
OG0013263	1	0	1	1	3
OG0013264	1	1	0	1	3
OG0013265	1	0	2	0	3
OG0013266	1	0	0	2	3
OG0013267	1	1	0	1	3
OG0013268	1	0	0	2	3
OG0013269	1	0	1	1	3
OG0013270	1	1	0	1	3
OG0013271	1	0	1	1	3
OG0013272	1	1	0	1	3
OG0013273	1	0	0	2	3
OG0013274	1	0	1	1	3
OG0013275	1	0	1	1	3
OG0013276	1	1	0	1	3
OG0013277	1	0	1	1	3
OG0013278	1	0	1	1	3
OG0013279	1	1	1	0	3
OG0013280	1	0	1	1	3
OG0013281	1	0	0	2	3
OG0013282	1	1	0	1	3
OG0013283	3	0	0	0	3
OG0013284	1	1	1	0	3
OG0013285	1	1	0	1	3
OG0013286	1	1	0	1	3
OG0013287	1	1	0	1	3
OG0013288	1	0	1	1	3
OG0013289	1	1	0	1	3
OG0013290	1	0	0	2	3
OG0013291	1	0	1	1	3
OG0013292	1	0	1	1	3
OG0013293	1	0	0	2	3
OG0013294	1	1	0	1	3
OG0013295	1	1	0	1	3
OG0013296	1	0	1	1	3
OG0013297	1	1	0	1	3
OG0013298	1	0	1	1	3
OG0013299	1	0	1	1	3
OG0013300	1	1	0	1	3
OG0013301	1	1	0	1	3
OG0013302	1	0	1	1	3
OG0013303	1	0	1	1	3
OG0013304	1	0	0	2	3
OG0013305	1	0	0	2	3
OG0013306	1	1	0	1	3
OG0013307	1	1	0	1	3
OG0013308	1	0	1	1	3
OG0013309	1	0	1	1	3
OG0013310	1	1	0	1	3
OG0013311	1	1	0	1	3
OG0013312	1	0	1	1	3
OG0013313	1	1	0	1	3
OG0013314	1	0	1	1	3
OG0013315	1	1	0	1	3
OG0013316	1	0	0	2	3
OG0013317	1	0	1	1	3
OG0013318	1	1	0	1	3
OG0013319	3	0	0	0	3
OG0013320	3	0	0	0	3
OG0013321	1	1	0	1	3
OG0013322	1	0	0	2	3
OG0013323	1	1	0	1	3
OG0013324	3	0	0	0	3
OG0013325	1	0	0	2	3
OG0013326	3	0	0	0	3
OG0013327	1	0	1	1	3
OG0013328	1	0	1	1	3
OG0013329	1	0	1	1	3
OG0013330	1	0	1	1	3
OG0013331	1	0	0	2	3
OG0013332	2	0	0	1	3
OG0013333	2	0	0	1	3
OG0013334	1	0	0	2	3
OG0013335	1	0	1	1	3
OG0013336	1	1	0	1	3
OG0013337	1	0	1	1	3
OG0013338	1	1	0	1	3
OG0013339	1	0	0	2	3
OG0013340	1	0	1	1	3
OG0013341	1	0	1	1	3
OG0013342	1	1	0	1	3
OG0013343	1	1	0	1	3
OG0013344	2	0	0	1	3
OG0013345	1	0	1	1	3
OG0013346	1	0	0	2	3
OG0013347	1	0	1	1	3
OG0013348	1	0	0	2	3
OG0013349	1	1	0	1	3
OG0013350	1	0	0	2	3
OG0013351	1	1	0	1	3
OG0013352	1	0	1	1	3
OG0013353	2	1	0	0	3
OG0013354	1	0	0	2	3
OG0013355	1	1	0	1	3
OG0013356	1	0	1	1	3
OG0013357	1	1	0	1	3
OG0013358	1	0	0	2	3
OG0013359	1	1	0	1	3
OG0013360	1	0	0	2	3
OG0013361	1	1	0	1	3
OG0013362	1	1	0	1	3
OG0013363	1	1	0	1	3
OG0013364	1	1	0	1	3
OG0013365	1	0	0	2	3
OG0013366	1	1	0	1	3
OG0013367	1	0	0	2	3
OG0013368	1	1	0	1	3
OG0013369	1	1	0	1	3
OG0013370	1	0	0	2	3
OG0013371	1	1	0	1	3
OG0013372	1	1	1	0	3
OG0013373	1	0	1	1	3
OG0013374	1	1	1	0	3
OG0013375	1	0	0	2	3
OG0013376	1	1	0	1	3
OG0013377	1	0	1	1	3
OG0013378	1	0	0	2	3
OG0013379	1	1	0	1	3
OG0013380	1	1	0	1	3
OG0013381	1	0	1	1	3
OG0013382	1	1	0	1	3
OG0013383	1	1	0	1	3
OG0013384	1	0	1	1	3
OG0013385	1	0	1	1	3
OG0013386	1	1	0	1	3
OG0013387	1	1	0	1	3
OG0013388	2	0	0	1	3
OG0013389	1	1	0	1	3
OG0013390	1	1	0	1	3
OG0013391	1	0	1	1	3
OG0013392	1	1	0	1	3
OG0013393	1	0	1	1	3
OG0013394	1	1	0	1	3
OG0013395	1	1	0	1	3
OG0013396	1	1	0	1	3
OG0013397	1	1	0	1	3
OG0013398	2	0	0	1	3
OG0013399	1	0	0	2	3
OG0013400	1	1	1	0	3
OG0013401	1	0	1	1	3
OG0013402	1	0	1	1	3
OG0013403	2	0	0	1	3
OG0013404	1	0	0	2	3
OG0013405	1	0	1	1	3
OG0013406	1	0	1	1	3
OG0013407	1	1	0	1	3
OG0013408	1	1	0	1	3
OG0013409	1	0	1	1	3
OG0013410	1	1	1	0	3
OG0013411	1	0	1	1	3
OG0013412	1	0	1	1	3
OG0013413	1	0	0	2	3
OG0013414	1	0	1	1	3
OG0013415	1	1	0	1	3
OG0013416	1	0	1	1	3
OG0013417	1	1	0	1	3
OG0013418	1	0	1	1	3
OG0013419	3	0	0	0	3
OG0013420	1	0	1	1	3
OG0013421	1	0	1	1	3
OG0013422	1	0	0	2	3
OG0013423	1	1	0	1	3
OG0013424	1	1	0	1	3
OG0013425	1	0	1	1	3
OG0013426	1	1	0	1	3
OG0013427	1	0	0	2	3
OG0013428	1	0	1	1	3
OG0013429	1	0	1	1	3
OG0013430	1	1	0	1	3
OG0013431	1	0	0	2	3
OG0013432	1	1	0	1	3
OG0013433	1	1	0	1	3
OG0013434	1	0	0	2	3
OG0013435	1	0	0	2	3
OG0013436	1	0	1	1	3
OG0013437	1	0	0	2	3
OG0013438	1	1	0	1	3
OG0013439	1	1	0	1	3
OG0013440	1	0	1	1	3
OG0013441	1	0	1	1	3
OG0013442	1	0	0	2	3
OG0013443	2	0	0	1	3
OG0013444	1	0	0	2	3
OG0013445	1	1	0	1	3
OG0013446	1	0	0	2	3
OG0013447	1	1	0	1	3
OG0013448	1	0	0	2	3
OG0013449	1	1	0	1	3
OG0013450	1	1	0	1	3
OG0013451	1	1	0	1	3
OG0013452	2	0	0	1	3
OG0013453	1	0	1	1	3
OG0013454	1	0	1	1	3
OG0013455	1	0	1	1	3
OG0013456	1	0	1	1	3
OG0013457	2	0	0	1	3
OG0013458	1	1	0	1	3
OG0013459	1	1	0	1	3
OG0013460	1	0	1	1	3
OG0013461	1	1	0	1	3
OG0013462	1	0	0	2	3
OG0013463	1	0	0	2	3
OG0013464	1	1	0	1	3
OG0013465	1	0	1	1	3
OG0013466	1	0	1	1	3
OG0013467	1	1	0	1	3
OG0013468	1	0	1	1	3
OG0013469	3	0	0	0	3
OG0013470	1	0	0	2	3
OG0013471	1	1	0	1	3
OG0013472	1	0	0	2	3
OG0013473	1	1	0	1	3
OG0013474	1	1	0	1	3
OG0013475	1	1	0	1	3
OG0013476	1	0	0	2	3
OG0013477	1	1	0	1	3
OG0013478	1	0	0	2	3
OG0013479	1	0	0	2	3
OG0013480	1	1	0	1	3
OG0013481	1	1	0	1	3
OG0013482	1	0	1	1	3
OG0013483	1	0	0	2	3
OG0013484	1	0	1	1	3
OG0013485	1	0	1	1	3
OG0013486	1	2	0	0	3
OG0013487	1	1	0	1	3
OG0013488	1	1	0	1	3
OG0013489	1	0	0	2	3
OG0013490	1	1	0	1	3
OG0013491	1	1	0	1	3
OG0013492	1	0	0	2	3
OG0013493	1	0	0	2	3
OG0013494	1	0	1	1	3
OG0013495	1	1	0	1	3
OG0013496	1	1	0	1	3
OG0013497	1	1	0	1	3
OG0013498	1	0	1	1	3
OG0013499	1	0	0	2	3
OG0013500	1	1	0	1	3
OG0013501	1	0	0	2	3
OG0013502	1	1	0	1	3
OG0013503	1	1	0	1	3
OG0013504	1	1	0	1	3
OG0013505	1	0	0	2	3
OG0013506	1	0	0	2	3
OG0013507	1	2	0	0	3
OG0013508	2	0	0	1	3
OG0013509	1	1	0	1	3
OG0013510	1	1	0	1	3
OG0013511	1	0	1	1	3
OG0013512	1	0	1	1	3
OG0013513	1	1	0	1	3
OG0013514	1	1	0	1	3
OG0013515	1	0	1	1	3
OG0013516	1	0	1	1	3
OG0013517	1	0	1	1	3
OG0013518	1	0	1	1	3
OG0013519	1	1	0	1	3
OG0013520	1	0	2	0	3
OG0013521	1	0	1	1	3
OG0013522	1	0	1	1	3
OG0013523	1	1	0	1	3
OG0013524	1	0	0	2	3
OG0013525	2	0	0	1	3
OG0013526	1	0	2	0	3
OG0013527	1	1	0	1	3
OG0013528	1	1	0	1	3
OG0013529	1	0	0	2	3
OG0013530	1	1	0	1	3
OG0013531	2	0	0	1	3
OG0013532	1	1	0	1	3
OG0013533	1	0	1	1	3
OG0013534	1	1	0	1	3
OG0013535	1	0	1	1	3
OG0013536	1	0	1	1	3
OG0013537	1	0	1	1	3
OG0013538	1	1	0	1	3
OG0013539	1	0	1	1	3
OG0013540	1	1	0	1	3
OG0013541	1	0	1	1	3
OG0013542	1	0	1	1	3
OG0013543	1	1	1	0	3
OG0013544	1	1	1	0	3
OG0013545	1	1	0	1	3
OG0013546	1	0	1	1	3
OG0013547	1	1	0	1	3
OG0013548	1	0	1	1	3
OG0013549	1	1	0	1	3
OG0013550	1	0	0	2	3
OG0013551	1	0	1	1	3
OG0013552	1	1	0	1	3
OG0013553	1	0	1	1	3
OG0013554	1	0	1	1	3
OG0013555	1	0	1	1	3
OG0013556	1	0	1	1	3
OG0013557	1	1	0	1	3
OG0013558	1	0	1	1	3
OG0013559	1	0	0	2	3
OG0013560	1	0	1	1	3
OG0013561	1	1	0	1	3
OG0013562	1	1	0	1	3
OG0013563	1	1	0	1	3
OG0013564	1	0	0	2	3
OG0013565	1	1	0	1	3
OG0013566	3	0	0	0	3
OG0013567	1	0	0	2	3
OG0013568	3	0	0	0	3
OG0013569	1	0	1	1	3
OG0013570	1	1	0	1	3
OG0013571	1	1	0	1	3
OG0013572	1	1	0	1	3
OG0013573	1	1	0	1	3
OG0013574	1	0	1	1	3
OG0013575	1	0	1	1	3
OG0013576	3	0	0	0	3
OG0013577	1	0	1	1	3
OG0013578	1	0	1	1	3
OG0013579	1	0	0	2	3
OG0013580	1	1	0	1	3
OG0013581	1	0	0	2	3
OG0013582	1	0	1	1	3
OG0013583	1	0	1	1	3
OG0013584	1	0	0	2	3
OG0013585	1	0	1	1	3
OG0013586	1	0	1	1	3
OG0013587	1	1	0	1	3
OG0013588	1	1	0	1	3
OG0013589	1	0	1	1	3
OG0013590	1	1	0	1	3
OG0013591	1	1	0	1	3
OG0013592	1	0	1	1	3
OG0013593	1	1	0	1	3
OG0013594	1	0	1	1	3
OG0013595	1	1	0	1	3
OG0013596	1	1	0	1	3
OG0013597	1	0	1	1	3
OG0013598	1	1	0	1	3
OG0013599	1	1	0	1	3
OG0013600	2	0	0	1	3
OG0013601	1	1	0	1	3
OG0013602	1	0	0	2	3
OG0013603	1	0	1	1	3
OG0013604	1	1	0	1	3
OG0013605	1	0	0	2	3
OG0013606	2	0	0	1	3
OG0013607	1	0	1	1	3
OG0013608	1	1	0	1	3
OG0013609	1	1	0	1	3
OG0013610	1	0	1	1	3
OG0013611	1	1	0	1	3
OG0013612	1	0	1	1	3
OG0013613	1	0	1	1	3
OG0013614	1	0	1	1	3
OG0013615	1	0	1	1	3
OG0013616	1	1	0	1	3
OG0013617	1	0	0	2	3
OG0013618	1	1	0	1	3
OG0013619	1	0	1	1	3
OG0013620	1	0	0	2	3
OG0013621	1	1	0	1	3
OG0013622	1	0	1	1	3
OG0013623	1	0	0	2	3
OG0013624	1	0	1	1	3
OG0013625	1	1	0	1	3
OG0013626	1	1	0	1	3
OG0013627	1	0	0	2	3
OG0013628	1	1	0	1	3
OG0013629	1	0	1	1	3
OG0013630	1	1	0	1	3
OG0013631	1	0	0	2	3
OG0013632	1	0	1	1	3
OG0013633	1	1	0	1	3
OG0013634	1	1	0	1	3
OG0013635	1	0	0	2	3
OG0013636	1	0	1	1	3
OG0013637	1	2	0	0	3
OG0013638	1	1	0	1	3
OG0013639	1	0	0	2	3
OG0013640	1	0	1	1	3
OG0013641	1	0	1	1	3
OG0013642	1	1	0	1	3
OG0013643	1	1	0	1	3
OG0013644	1	0	0	2	3
OG0013645	1	1	0	1	3
OG0013646	1	0	1	1	3
OG0013647	1	0	1	1	3
OG0013648	1	0	0	2	3
OG0013649	1	1	0	1	3
OG0013650	1	1	0	1	3
OG0013651	1	1	0	1	3
OG0013652	1	1	0	1	3
OG0013653	1	0	0	2	3
OG0013654	1	1	0	1	3
OG0013655	1	1	0	1	3
OG0013656	1	0	1	1	3
OG0013657	1	0	1	1	3
OG0013658	1	1	0	1	3
OG0013659	1	0	1	1	3
OG0013660	1	0	1	1	3
OG0013661	1	0	0	2	3
OG0013662	1	0	0	2	3
OG0013663	1	0	0	2	3
OG0013664	1	1	0	1	3
OG0013665	1	1	0	1	3
OG0013666	1	0	1	1	3
OG0013667	1	0	0	2	3
OG0013668	1	0	0	2	3
OG0013669	1	1	0	1	3
OG0013670	1	1	0	1	3
OG0013671	1	0	1	1	3
OG0013672	2	0	0	1	3
OG0013673	1	1	1	0	3
OG0013674	1	0	1	1	3
OG0013675	1	0	0	2	3
OG0013676	1	1	0	1	3
OG0013677	1	1	0	1	3
OG0013678	1	0	0	2	3
OG0013679	2	0	0	1	3
OG0013680	1	0	1	1	3
OG0013681	2	0	0	1	3
OG0013682	1	0	1	1	3
OG0013683	1	1	0	1	3
OG0013684	1	1	0	1	3
OG0013685	1	0	1	1	3
OG0013686	1	0	0	2	3
OG0013687	1	1	1	0	3
OG0013688	1	0	1	1	3
OG0013689	1	1	1	0	3
OG0013690	1	0	1	1	3
OG0013691	1	1	0	1	3
OG0013692	1	1	0	1	3
OG0013693	1	0	1	1	3
OG0013694	1	0	1	1	3
OG0013695	1	1	0	1	3
OG0013696	1	0	1	1	3
OG0013697	1	1	0	1	3
OG0013698	1	0	0	2	3
OG0013699	1	0	1	1	3
OG0013700	1	1	0	1	3
OG0013701	3	0	0	0	3
OG0013702	1	0	1	1	3
OG0013703	1	0	1	1	3
OG0013704	1	0	1	1	3
OG0013705	1	1	0	1	3
OG0013706	1	0	0	2	3
OG0013707	1	0	0	2	3
OG0013708	1	0	1	1	3
OG0013709	1	1	0	1	3
OG0013710	1	0	1	1	3
OG0013711	1	1	0	1	3
OG0013712	1	0	1	1	3
OG0013713	1	0	2	0	3
OG0013714	1	1	0	1	3
OG0013715	1	0	0	2	3
OG0013716	1	1	0	1	3
OG0013717	1	0	0	2	3
OG0013718	1	0	0	2	3
OG0013719	1	1	0	1	3
OG0013720	1	0	0	2	3
OG0013721	1	0	0	2	3
OG0013722	1	1	1	0	3
OG0013723	1	1	0	1	3
OG0013724	1	0	0	2	3
OG0013725	1	1	1	0	3
OG0013726	1	1	0	1	3
OG0013727	1	0	0	2	3
OG0013728	1	0	0	2	3
OG0013729	1	1	1	0	3
OG0013730	1	0	1	1	3
OG0013731	1	1	1	0	3
OG0013732	1	1	0	1	3
OG0013733	1	1	0	1	3
OG0013734	1	0	1	1	3
OG0013735	1	1	0	1	3
OG0013736	1	0	1	1	3
OG0013737	1	1	0	1	3
OG0013738	1	0	1	1	3
OG0013739	1	1	1	0	3
OG0013740	1	0	0	2	3
OG0013741	1	0	1	1	3
OG0013742	1	1	0	1	3
OG0013743	1	0	0	2	3
OG0013744	1	0	0	2	3
OG0013745	1	0	1	1	3
OG0013746	1	1	0	1	3
OG0013747	1	1	0	1	3
OG0013748	1	1	0	1	3
OG0013749	1	1	0	1	3
OG0013750	1	1	0	1	3
OG0013751	1	1	1	0	3
OG0013752	1	1	0	1	3
OG0013753	1	0	0	2	3
OG0013754	1	0	0	2	3
OG0013755	1	1	0	1	3
OG0013756	1	1	1	0	3
OG0013757	1	0	0	2	3
OG0013758	1	1	0	1	3
OG0013759	1	0	1	1	3
OG0013760	1	0	1	1	3
OG0013761	1	0	1	1	3
OG0013762	1	1	0	1	3
OG0013763	1	1	0	1	3
OG0013764	1	1	0	1	3
OG0013765	1	0	0	2	3
OG0013766	1	0	1	1	3
OG0013767	1	1	0	1	3
OG0013768	1	1	0	1	3
OG0013769	1	0	1	1	3
OG0013770	3	0	0	0	3
OG0013771	1	0	1	1	3
OG0013772	2	0	0	1	3
OG0013773	1	0	1	1	3
OG0013774	1	0	0	2	3
OG0013775	1	0	1	1	3
OG0013776	1	0	1	1	3
OG0013777	1	0	0	2	3
OG0013778	1	0	0	2	3
OG0013779	1	0	0	2	3
OG0013780	1	1	0	1	3
OG0013781	1	1	0	1	3
OG0013782	3	0	0	0	3
OG0013783	1	0	0	2	3
OG0013784	1	1	0	1	3
OG0013785	1	1	0	1	3
OG0013786	1	0	1	1	3
OG0013787	1	0	0	2	3
OG0013788	1	0	0	2	3
OG0013789	1	0	1	1	3
OG0013790	1	0	1	1	3
OG0013791	1	0	0	2	3
OG0013792	1	0	1	1	3
OG0013793	1	0	1	1	3
OG0013794	1	0	0	2	3
OG0013795	1	0	1	1	3
OG0013796	1	1	0	1	3
OG0013797	1	1	0	1	3
OG0013798	1	0	1	1	3
OG0013799	1	1	0	1	3
OG0013800	2	0	0	1	3
OG0013801	1	0	1	1	3
OG0013802	1	0	0	2	3
OG0013803	1	1	1	0	3
OG0013804	1	1	0	1	3
OG0013805	1	1	0	1	3
OG0013806	1	0	0	2	3
OG0013807	1	1	0	1	3
OG0013808	1	0	1	1	3
OG0013809	1	0	1	1	3
OG0013810	2	0	0	1	3
OG0013811	1	0	1	1	3
OG0013812	1	0	0	2	3
OG0013813	1	0	1	1	3
OG0013814	1	0	1	1	3
OG0013815	1	0	1	1	3
OG0013816	1	0	1	1	3
OG0013817	1	0	1	1	3
OG0013818	1	0	1	1	3
OG0013819	1	0	1	1	3
OG0013820	1	0	0	2	3
OG0013821	1	1	0	1	3
OG0013822	1	1	0	1	3
OG0013823	1	0	1	1	3
OG0013824	1	0	0	2	3
OG0013825	1	1	0	1	3
OG0013826	1	0	0	2	3
OG0013827	1	1	1	0	3
OG0013828	1	0	1	1	3
OG0013829	1	0	0	2	3
OG0013830	1	1	0	1	3
OG0013831	1	0	0	2	3
OG0013832	2	0	0	1	3
OG0013833	1	0	0	2	3
OG0013834	1	0	1	1	3
OG0013835	1	0	0	2	3
OG0013836	1	1	0	1	3
OG0013837	1	1	0	1	3
OG0013838	1	0	1	1	3
OG0013839	1	0	1	1	3
OG0013840	1	1	0	1	3
OG0013841	1	1	0	1	3
OG0013842	1	1	0	1	3
OG0013843	1	1	0	1	3
OG0013844	1	1	0	1	3
OG0013845	1	0	1	1	3
OG0013846	1	1	0	1	3
OG0013847	1	1	0	1	3
OG0013848	1	1	0	1	3
OG0013849	1	0	0	2	3
OG0013850	1	1	0	1	3
OG0013851	1	0	0	2	3
OG0013852	1	1	0	1	3
OG0013853	1	1	0	1	3
OG0013854	1	0	0	2	3
OG0013855	1	0	1	1	3
OG0013856	1	1	0	1	3
OG0013857	1	1	0	1	3
OG0013858	1	0	0	2	3
OG0013859	1	1	0	1	3
OG0013860	1	1	0	1	3
OG0013861	1	0	1	1	3
OG0013862	1	1	0	1	3
OG0013863	1	0	1	1	3
OG0013864	1	0	1	1	3
OG0013865	1	1	0	1	3
OG0013866	1	0	0	2	3
OG0013867	2	0	0	1	3
OG0013868	1	1	0	1	3
OG0013869	1	0	1	1	3
OG0013870	1	0	1	1	3
OG0013871	1	1	0	1	3
OG0013872	1	1	0	1	3
OG0013873	1	1	0	1	3
OG0013874	1	1	0	1	3
OG0013875	1	0	0	2	3
OG0013876	1	1	0	1	3
OG0013877	1	1	0	1	3
OG0013878	1	1	0	1	3
OG0013879	1	0	0	2	3
OG0013880	1	1	0	1	3
OG0013881	1	0	1	1	3
OG0013882	1	0	0	2	3
OG0013883	1	0	1	1	3
OG0013884	1	0	1	1	3
OG0013885	1	1	0	1	3
OG0013886	1	0	1	1	3
OG0013887	1	1	0	1	3
OG0013888	1	0	1	1	3
OG0013889	1	0	1	1	3
OG0013890	1	0	1	1	3
OG0013891	1	0	1	1	3
OG0013892	1	0	0	2	3
OG0013893	1	0	1	1	3
OG0013894	1	0	0	2	3
OG0013895	1	0	0	2	3
OG0013896	1	0	1	1	3
OG0013897	1	1	0	1	3
OG0013898	1	1	0	1	3
OG0013899	1	0	0	2	3
OG0013900	1	0	1	1	3
OG0013901	1	1	0	1	3
OG0013902	1	1	1	0	3
OG0013903	1	0	1	1	3
OG0013904	1	0	1	1	3
OG0013905	1	1	0	1	3
OG0013906	1	0	1	1	3
OG0013907	1	0	0	2	3
OG0013908	1	1	0	1	3
OG0013909	2	0	0	1	3
OG0013910	1	0	1	1	3
OG0013911	1	1	0	1	3
OG0013912	1	1	0	1	3
OG0013913	1	0	0	2	3
OG0013914	1	0	1	1	3
OG0013915	3	0	0	0	3
OG0013916	1	2	0	0	3
OG0013917	1	0	1	1	3
OG0013918	1	1	1	0	3
OG0013919	1	0	1	1	3
OG0013920	1	1	0	1	3
OG0013921	1	1	0	1	3
OG0013922	1	1	0	1	3
OG0013923	1	0	1	1	3
OG0013924	1	0	1	1	3
OG0013925	1	0	1	1	3
OG0013926	1	1	0	1	3
OG0013927	1	0	1	1	3
OG0013928	1	0	1	1	3
OG0013929	1	0	1	1	3
OG0013930	1	1	0	1	3
OG0013931	2	0	0	1	3
OG0013932	1	1	0	1	3
OG0013933	1	1	1	0	3
OG0013934	1	1	0	1	3
OG0013935	1	1	1	0	3
OG0013936	1	1	0	1	3
OG0013937	1	1	0	1	3
OG0013938	1	1	0	1	3
OG0013939	1	0	0	2	3
OG0013940	1	1	0	1	3
OG0013941	1	1	1	0	3
OG0013942	1	0	0	2	3
OG0013943	1	1	0	1	3
OG0013944	1	1	1	0	3
OG0013945	2	0	0	1	3
OG0013946	1	1	0	1	3
OG0013947	1	0	0	2	3
OG0013948	1	1	0	1	3
OG0013949	1	0	1	1	3
OG0013950	1	0	0	2	3
OG0013951	1	0	1	1	3
OG0013952	1	0	0	2	3
OG0013953	1	0	1	1	3
OG0013954	1	1	0	1	3
OG0013955	1	1	0	1	3
OG0013956	1	1	0	1	3
OG0013957	1	1	1	0	3
OG0013958	3	0	0	0	3
OG0013959	1	1	0	1	3
OG0013960	1	1	0	1	3
OG0013961	1	1	0	1	3
OG0013962	1	1	0	1	3
OG0013963	1	0	0	2	3
OG0013964	1	0	1	1	3
OG0013965	1	1	0	1	3
OG0013966	1	0	1	1	3
OG0013967	1	1	0	1	3
OG0013968	1	0	1	1	3
OG0013969	1	1	0	1	3
OG0013970	1	1	0	1	3
OG0013971	1	0	0	2	3
OG0013972	1	0	0	2	3
OG0013973	1	0	0	2	3
OG0013974	1	0	1	1	3
OG0013975	1	0	1	1	3
OG0013976	1	1	0	1	3
OG0013977	1	0	1	1	3
OG0013978	1	1	0	1	3
OG0013979	1	2	0	0	3
OG0013980	1	1	0	1	3
OG0013981	1	1	0	1	3
OG0013982	1	1	0	1	3
OG0013983	1	0	0	2	3
OG0013984	1	0	0	2	3
OG0013985	1	1	0	1	3
OG0013986	1	1	0	1	3
OG0013987	1	0	1	1	3
OG0013988	1	0	1	1	3
OG0013989	1	1	1	0	3
OG0013990	1	0	1	1	3
OG0013991	1	0	0	2	3
OG0013992	1	0	0	2	3
OG0013993	1	0	1	1	3
OG0013994	1	1	0	1	3
OG0013995	1	1	0	1	3
OG0013996	1	1	0	1	3
OG0013997	1	1	0	1	3
OG0013998	2	0	0	1	3
OG0013999	1	0	1	1	3
OG0014000	1	0	0	2	3
OG0014001	1	0	0	2	3
OG0014002	1	0	0	2	3
OG0014003	1	1	0	1	3
OG0014004	1	1	0	1	3
OG0014005	1	1	0	1	3
OG0014006	2	0	0	1	3
OG0014007	1	0	1	1	3
OG0014008	1	0	1	1	3
OG0014009	1	0	1	1	3
OG0014010	1	0	1	1	3
OG0014011	1	0	1	1	3
OG0014012	1	0	0	2	3
OG0014013	1	0	1	1	3
OG0014014	1	0	1	1	3
OG0014015	1	1	0	1	3
OG0014016	1	1	0	1	3
OG0014017	1	1	0	1	3
OG0014018	1	2	0	0	3
OG0014019	1	0	0	2	3
OG0014020	1	0	1	1	3
OG0014021	1	0	1	1	3
OG0014022	1	0	0	2	3
OG0014023	1	1	0	1	3
OG0014024	1	1	0	1	3
OG0014025	1	1	0	1	3
OG0014026	1	1	0	1	3
OG0014027	1	1	0	1	3
OG0014028	1	1	0	1	3
OG0014029	1	0	1	1	3
OG0014030	1	0	1	1	3
OG0014031	1	1	0	1	3
OG0014032	1	0	1	1	3
OG0014033	1	0	1	1	3
OG0014034	1	0	0	2	3
OG0014035	1	1	0	1	3
OG0014036	1	1	0	1	3
OG0014037	1	0	1	1	3
OG0014038	1	2	0	0	3
OG0014039	1	2	0	0	3
OG0014040	1	0	0	2	3
OG0014041	1	0	0	2	3
OG0014042	2	0	0	1	3
OG0014043	1	0	0	2	3
OG0014044	2	0	0	1	3
OG0014045	1	1	0	1	3
OG0014046	1	0	0	2	3
OG0014047	2	0	0	1	3
OG0014048	1	0	0	2	3
OG0014049	1	0	0	2	3
OG0014050	1	0	1	1	3
OG0014051	1	0	1	1	3
OG0014052	1	1	0	1	3
OG0014053	1	1	0	1	3
OG0014054	1	1	1	0	3
OG0014055	1	0	1	1	3
OG0014056	1	0	1	1	3
OG0014057	1	1	1	0	3
OG0014058	1	1	0	1	3
OG0014059	1	0	0	2	3
OG0014060	1	0	0	2	3
OG0014061	1	0	0	2	3
OG0014062	1	0	0	2	3
OG0014063	1	1	0	1	3
OG0014064	1	0	1	1	3
OG0014065	1	0	0	2	3
OG0014066	1	0	1	1	3
OG0014067	1	0	0	2	3
OG0014068	1	1	1	0	3
OG0014069	1	1	0	1	3
OG0014070	1	1	0	1	3
OG0014071	1	0	1	1	3
OG0014072	1	0	0	2	3
OG0014073	1	1	0	1	3
OG0014074	1	1	0	1	3
OG0014075	1	0	0	2	3
OG0014076	1	1	1	0	3
OG0014077	1	1	1	0	3
OG0014078	1	0	1	1	3
OG0014079	1	1	1	0	3
OG0014080	1	1	0	1	3
OG0014081	1	0	0	2	3
OG0014082	1	1	1	0	3
OG0014083	1	1	0	1	3
OG0014084	1	1	0	1	3
OG0014085	1	0	1	1	3
OG0014086	1	0	2	0	3
OG0014087	1	0	1	1	3
OG0014088	1	1	0	1	3
OG0014089	1	0	1	1	3
OG0014090	0	3	0	0	3
OG0014091	0	3	0	0	3
OG0014092	0	3	0	0	3
OG0014093	0	3	0	0	3
OG0014094	0	3	0	0	3
OG0014095	0	3	0	0	3
OG0014096	0	3	0	0	3
OG0014097	0	2	1	0	3
OG0014098	0	3	0	0	3
OG0014099	0	3	0	0	3
OG0014100	0	3	0	0	3
OG0014101	0	3	0	0	3
OG0014102	0	3	0	0	3
OG0014103	0	3	0	0	3
OG0014104	0	3	0	0	3
OG0014105	0	3	0	0	3
OG0014106	0	3	0	0	3
OG0014107	0	3	0	0	3
OG0014108	0	3	0	0	3
OG0014109	0	3	0	0	3
OG0014110	0	3	0	0	3
OG0014111	0	3	0	0	3
OG0014112	0	3	0	0	3
OG0014113	0	3	0	0	3
OG0014114	0	3	0	0	3
OG0014115	0	3	0	0	3
OG0014116	0	3	0	0	3
OG0014117	0	3	0	0	3
OG0014118	0	3	0	0	3
OG0014119	0	3	0	0	3
OG0014120	0	3	0	0	3
OG0014121	0	2	1	0	3
OG0014122	0	3	0	0	3
OG0014123	0	2	1	0	3
OG0014124	0	3	0	0	3
OG0014125	0	3	0	0	3
OG0014126	0	3	0	0	3
OG0014127	0	3	0	0	3
OG0014128	0	3	0	0	3
OG0014129	0	3	0	0	3
OG0014130	0	1	0	2	3
OG0014131	0	3	0	0	3
OG0014132	0	3	0	0	3
OG0014133	0	3	0	0	3
OG0014134	0	3	0	0	3
OG0014135	0	3	0	0	3
OG0014136	0	3	0	0	3
OG0014137	0	3	0	0	3
OG0014138	0	3	0	0	3
OG0014139	0	3	0	0	3
OG0014140	0	3	0	0	3
OG0014141	0	3	0	0	3
OG0014142	0	3	0	0	3
OG0014143	0	3	0	0	3
OG0014144	0	3	0	0	3
OG0014145	0	3	0	0	3
OG0014146	0	3	0	0	3
OG0014147	0	3	0	0	3
OG0014148	0	3	0	0	3
OG0014149	0	3	0	0	3
OG0014150	0	3	0	0	3
OG0014151	0	3	0	0	3
OG0014152	0	3	0	0	3
OG0014153	0	3	0	0	3
OG0014154	0	3	0	0	3
OG0014155	0	3	0	0	3
OG0014156	0	3	0	0	3
OG0014157	0	3	0	0	3
OG0014158	0	3	0	0	3
OG0014159	0	3	0	0	3
OG0014160	0	3	0	0	3
OG0014161	0	3	0	0	3
OG0014162	0	3	0	0	3
OG0014163	0	3	0	0	3
OG0014164	0	3	0	0	3
OG0014165	0	3	0	0	3
OG0014166	0	3	0	0	3
OG0014167	0	3	0	0	3
OG0014168	0	3	0	0	3
OG0014169	0	3	0	0	3
OG0014170	0	3	0	0	3
OG0014171	0	3	0	0	3
OG0014172	0	3	0	0	3
OG0014173	0	3	0	0	3
OG0014174	0	1	0	2	3
OG0014175	0	3	0	0	3
OG0014176	0	3	0	0	3
OG0014177	0	3	0	0	3
OG0014178	0	3	0	0	3
OG0014179	0	3	0	0	3
OG0014180	0	3	0	0	3
OG0014181	0	3	0	0	3
OG0014182	0	3	0	0	3
OG0014183	0	3	0	0	3
OG0014184	0	3	0	0	3
OG0014185	0	3	0	0	3
OG0014186	0	3	0	0	3
OG0014187	0	3	0	0	3
OG0014188	0	3	0	0	3
OG0014189	0	2	1	0	3
OG0014190	0	3	0	0	3
OG0014191	0	3	0	0	3
OG0014192	0	3	0	0	3
OG0014193	0	3	0	0	3
OG0014194	0	3	0	0	3
OG0014195	0	3	0	0	3
OG0014196	0	3	0	0	3
OG0014197	0	2	1	0	3
OG0014198	0	1	0	2	3
OG0014199	0	3	0	0	3
OG0014200	0	2	0	1	3
OG0014201	0	3	0	0	3
OG0014202	0	3	0	0	3
OG0014203	0	3	0	0	3
OG0014204	0	3	0	0	3
OG0014205	0	3	0	0	3
OG0014206	0	3	0	0	3
OG0014207	0	3	0	0	3
OG0014208	0	3	0	0	3
OG0014209	0	3	0	0	3
OG0014210	0	3	0	0	3
OG0014211	0	3	0	0	3
OG0014212	0	3	0	0	3
OG0014213	0	3	0	0	3
OG0014214	0	3	0	0	3
OG0014215	0	3	0	0	3
OG0014216	0	3	0	0	3
OG0014217	0	3	0	0	3
OG0014218	0	3	0	0	3
OG0014219	0	3	0	0	3
OG0014220	0	3	0	0	3
OG0014221	0	3	0	0	3
OG0014222	0	3	0	0	3
OG0014223	0	3	0	0	3
OG0014224	0	3	0	0	3
OG0014225	0	3	0	0	3
OG0014226	0	3	0	0	3
OG0014227	0	3	0	0	3
OG0014228	0	3	0	0	3
OG0014229	0	3	0	0	3
OG0014230	0	3	0	0	3
OG0014231	0	3	0	0	3
OG0014232	0	3	0	0	3
OG0014233	0	3	0	0	3
OG0014234	0	3	0	0	3
OG0014235	0	3	0	0	3
OG0014236	0	3	0	0	3
OG0014237	0	3	0	0	3
OG0014238	0	3	0	0	3
OG0014239	0	3	0	0	3
OG0014240	0	3	0	0	3
OG0014241	0	3	0	0	3
OG0014242	0	3	0	0	3
OG0014243	0	3	0	0	3
OG0014244	0	3	0	0	3
OG0014245	0	2	1	0	3
OG0014246	0	3	0	0	3
OG0014247	0	3	0	0	3
OG0014248	0	3	0	0	3
OG0014249	0	3	0	0	3
OG0014250	0	3	0	0	3
OG0014251	0	3	0	0	3
OG0014252	0	3	0	0	3
OG0014253	0	3	0	0	3
OG0014254	0	3	0	0	3
OG0014255	0	3	0	0	3
OG0014256	0	3	0	0	3
OG0014257	0	3	0	0	3
OG0014258	0	3	0	0	3
OG0014259	0	3	0	0	3
OG0014260	0	3	0	0	3
OG0014261	0	2	0	1	3
OG0014262	0	3	0	0	3
OG0014263	0	3	0	0	3
OG0014264	0	3	0	0	3
OG0014265	0	3	0	0	3
OG0014266	0	3	0	0	3
OG0014267	0	3	0	0	3
OG0014268	0	3	0	0	3
OG0014269	0	2	0	1	3
OG0014270	0	3	0	0	3
OG0014271	0	3	0	0	3
OG0014272	0	3	0	0	3
OG0014273	0	3	0	0	3
OG0014274	0	1	2	0	3
OG0014275	0	2	1	0	3
OG0014276	0	3	0	0	3
OG0014277	0	3	0	0	3
OG0014278	0	3	0	0	3
OG0014279	0	3	0	0	3
OG0014280	0	3	0	0	3
OG0014281	0	3	0	0	3
OG0014282	0	3	0	0	3
OG0014283	0	3	0	0	3
OG0014284	0	3	0	0	3
OG0014285	0	3	0	0	3
OG0014286	0	3	0	0	3
OG0014287	0	3	0	0	3
OG0014288	0	3	0	0	3
OG0014289	0	3	0	0	3
OG0014290	0	3	0	0	3
OG0014291	0	2	1	0	3
OG0014292	0	3	0	0	3
OG0014293	0	3	0	0	3
OG0014294	0	3	0	0	3
OG0014295	0	3	0	0	3
OG0014296	0	3	0	0	3
OG0014297	0	3	0	0	3
OG0014298	0	3	0	0	3
OG0014299	0	3	0	0	3
OG0014300	0	3	0	0	3
OG0014301	0	3	0	0	3
OG0014302	0	3	0	0	3
OG0014303	0	3	0	0	3
OG0014304	0	3	0	0	3
OG0014305	0	3	0	0	3
OG0014306	0	3	0	0	3
OG0014307	0	3	0	0	3
OG0014308	0	3	0	0	3
OG0014309	0	3	0	0	3
OG0014310	0	2	0	1	3
OG0014311	0	3	0	0	3
OG0014312	0	3	0	0	3
OG0014313	0	3	0	0	3
OG0014314	0	3	0	0	3
OG0014315	0	3	0	0	3
OG0014316	0	3	0	0	3
OG0014317	0	1	1	1	3
OG0014318	0	3	0	0	3
OG0014319	0	1	0	2	3
OG0014320	0	3	0	0	3
OG0014321	0	1	2	0	3
OG0014322	0	1	0	2	3
OG0014323	0	1	1	1	3
OG0014324	0	3	0	0	3
OG0014325	0	3	0	0	3
OG0014326	0	3	0	0	3
OG0014327	0	3	0	0	3
OG0014328	0	3	0	0	3
OG0014329	0	3	0	0	3
OG0014330	0	3	0	0	3
OG0014331	0	3	0	0	3
OG0014332	0	3	0	0	3
OG0014333	0	3	0	0	3
OG0014334	0	3	0	0	3
OG0014335	0	3	0	0	3
OG0014336	0	3	0	0	3
OG0014337	0	3	0	0	3
OG0014338	0	3	0	0	3
OG0014339	0	3	0	0	3
OG0014340	0	3	0	0	3
OG0014341	0	3	0	0	3
OG0014342	0	3	0	0	3
OG0014343	0	3	0	0	3
OG0014344	0	3	0	0	3
OG0014345	0	3	0	0	3
OG0014346	0	3	0	0	3
OG0014347	0	3	0	0	3
OG0014348	0	3	0	0	3
OG0014349	0	2	0	1	3
OG0014350	0	3	0	0	3
OG0014351	0	3	0	0	3
OG0014352	0	3	0	0	3
OG0014353	0	3	0	0	3
OG0014354	0	3	0	0	3
OG0014355	0	3	0	0	3
OG0014356	0	3	0	0	3
OG0014357	0	3	0	0	3
OG0014358	0	3	0	0	3
OG0014359	0	2	1	0	3
OG0014360	0	1	0	2	3
OG0014361	0	3	0	0	3
OG0014362	0	3	0	0	3
OG0014363	0	3	0	0	3
OG0014364	0	3	0	0	3
OG0014365	0	3	0	0	3
OG0014366	0	3	0	0	3
OG0014367	0	3	0	0	3
OG0014368	0	3	0	0	3
OG0014369	0	3	0	0	3
OG0014370	0	2	1	0	3
OG0014371	0	3	0	0	3
OG0014372	0	3	0	0	3
OG0014373	0	3	0	0	3
OG0014374	0	3	0	0	3
OG0014375	0	3	0	0	3
OG0014376	0	1	1	1	3
OG0014377	0	3	0	0	3
OG0014378	0	3	0	0	3
OG0014379	0	3	0	0	3
OG0014380	0	3	0	0	3
OG0014381	0	3	0	0	3
OG0014382	0	3	0	0	3
OG0014383	0	3	0	0	3
OG0014384	0	1	1	1	3
OG0014385	0	3	0	0	3
OG0014386	0	3	0	0	3
OG0014387	0	2	1	0	3
OG0014388	0	3	0	0	3
OG0014389	0	3	0	0	3
OG0014390	0	1	2	0	3
OG0014391	0	3	0	0	3
OG0014392	0	3	0	0	3
OG0014393	0	3	0	0	3
OG0014394	0	3	0	0	3
OG0014395	0	3	0	0	3
OG0014396	0	3	0	0	3
OG0014397	0	3	0	0	3
OG0014398	0	3	0	0	3
OG0014399	0	3	0	0	3
OG0014400	0	3	0	0	3
OG0014401	0	3	0	0	3
OG0014402	0	3	0	0	3
OG0014403	0	3	0	0	3
OG0014404	0	3	0	0	3
OG0014405	0	3	0	0	3
OG0014406	0	3	0	0	3
OG0014407	0	3	0	0	3
OG0014408	0	3	0	0	3
OG0014409	0	3	0	0	3
OG0014410	0	3	0	0	3
OG0014411	0	3	0	0	3
OG0014412	0	3	0	0	3
OG0014413	0	1	1	1	3
OG0014414	0	2	1	0	3
OG0014415	0	3	0	0	3
OG0014416	0	1	1	1	3
OG0014417	0	3	0	0	3
OG0014418	0	3	0	0	3
OG0014419	0	3	0	0	3
OG0014420	0	3	0	0	3
OG0014421	0	3	0	0	3
OG0014422	0	3	0	0	3
OG0014423	0	3	0	0	3
OG0014424	0	3	0	0	3
OG0014425	0	3	0	0	3
OG0014426	0	3	0	0	3
OG0014427	0	3	0	0	3
OG0014428	0	3	0	0	3
OG0014429	0	3	0	0	3
OG0014430	0	1	0	2	3
OG0014431	0	1	2	0	3
OG0014432	0	3	0	0	3
OG0014433	0	3	0	0	3
OG0014434	0	1	2	0	3
OG0014435	0	3	0	0	3
OG0014436	0	3	0	0	3
OG0014437	0	2	1	0	3
OG0014438	0	1	1	1	3
OG0014439	0	3	0	0	3
OG0014440	0	3	0	0	3
OG0014441	0	3	0	0	3
OG0014442	0	3	0	0	3
OG0014443	0	3	0	0	3
OG0014444	0	3	0	0	3
OG0014445	0	3	0	0	3
OG0014446	0	3	0	0	3
OG0014447	0	3	0	0	3
OG0014448	0	3	0	0	3
OG0014449	0	3	0	0	3
OG0014450	0	3	0	0	3
OG0014451	0	3	0	0	3
OG0014452	0	3	0	0	3
OG0014453	0	3	0	0	3
OG0014454	0	3	0	0	3
OG0014455	0	3	0	0	3
OG0014456	0	3	0	0	3
OG0014457	0	3	0	0	3
OG0014458	0	3	0	0	3
OG0014459	0	3	0	0	3
OG0014460	0	3	0	0	3
OG0014461	0	2	1	0	3
OG0014462	0	3	0	0	3
OG0014463	0	3	0	0	3
OG0014464	0	3	0	0	3
OG0014465	0	3	0	0	3
OG0014466	0	3	0	0	3
OG0014467	0	3	0	0	3
OG0014468	0	1	0	2	3
OG0014469	0	3	0	0	3
OG0014470	0	3	0	0	3
OG0014471	0	3	0	0	3
OG0014472	0	3	0	0	3
OG0014473	0	3	0	0	3
OG0014474	0	3	0	0	3
OG0014475	0	2	1	0	3
OG0014476	0	2	1	0	3
OG0014477	0	3	0	0	3
OG0014478	0	3	0	0	3
OG0014479	0	3	0	0	3
OG0014480	0	3	0	0	3
OG0014481	0	3	0	0	3
OG0014482	0	3	0	0	3
OG0014483	0	3	0	0	3
OG0014484	0	3	0	0	3
OG0014485	0	3	0	0	3
OG0014486	0	3	0	0	3
OG0014487	0	3	0	0	3
OG0014488	0	3	0	0	3
OG0014489	0	3	0	0	3
OG0014490	0	3	0	0	3
OG0014491	0	1	2	0	3
OG0014492	0	3	0	0	3
OG0014493	0	3	0	0	3
OG0014494	0	2	0	1	3
OG0014495	0	3	0	0	3
OG0014496	0	3	0	0	3
OG0014497	0	3	0	0	3
OG0014498	0	3	0	0	3
OG0014499	0	3	0	0	3
OG0014500	0	3	0	0	3
OG0014501	0	3	0	0	3
OG0014502	0	2	1	0	3
OG0014503	0	3	0	0	3
OG0014504	0	3	0	0	3
OG0014505	0	2	1	0	3
OG0014506	0	2	0	1	3
OG0014507	0	1	1	1	3
OG0014508	0	3	0	0	3
OG0014509	0	3	0	0	3
OG0014510	0	2	1	0	3
OG0014511	0	3	0	0	3
OG0014512	0	3	0	0	3
OG0014513	0	2	1	0	3
OG0014514	0	3	0	0	3
OG0014515	0	1	2	0	3
OG0014516	0	3	0	0	3
OG0014517	0	3	0	0	3
OG0014518	0	3	0	0	3
OG0014519	0	3	0	0	3
OG0014520	0	2	1	0	3
OG0014521	0	2	0	1	3
OG0014522	0	3	0	0	3
OG0014523	0	2	1	0	3
OG0014524	0	1	1	1	3
OG0014525	0	3	0	0	3
OG0014526	0	1	0	2	3
OG0014527	0	3	0	0	3
OG0014528	0	2	1	0	3
OG0014529	0	3	0	0	3
OG0014530	0	3	0	0	3
OG0014531	0	3	0	0	3
OG0014532	0	3	0	0	3
OG0014533	0	3	0	0	3
OG0014534	0	3	0	0	3
OG0014535	0	1	0	2	3
OG0014536	0	3	0	0	3
OG0014537	0	3	0	0	3
OG0014538	0	3	0	0	3
OG0014539	0	3	0	0	3
OG0014540	0	3	0	0	3
OG0014541	0	3	0	0	3
OG0014542	0	2	1	0	3
OG0014543	0	3	0	0	3
OG0014544	0	2	1	0	3
OG0014545	0	2	1	0	3
OG0014546	0	2	1	0	3
OG0014547	0	3	0	0	3
OG0014548	0	3	0	0	3
OG0014549	0	2	1	0	3
OG0014550	0	2	1	0	3
OG0014551	0	2	1	0	3
OG0014552	0	1	1	1	3
OG0014553	0	1	1	1	3
OG0014554	0	3	0	0	3
OG0014555	0	3	0	0	3
OG0014556	0	3	0	0	3
OG0014557	0	2	1	0	3
OG0014558	0	3	0	0	3
OG0014559	0	3	0	0	3
OG0014560	0	3	0	0	3
OG0014561	0	1	1	1	3
OG0014562	0	3	0	0	3
OG0014563	0	3	0	0	3
OG0014564	0	3	0	0	3
OG0014565	0	2	0	1	3
OG0014566	0	1	1	1	3
OG0014567	0	3	0	0	3
OG0014568	0	3	0	0	3
OG0014569	0	1	0	2	3
OG0014570	0	3	0	0	3
OG0014571	0	2	0	1	3
OG0014572	0	2	0	1	3
OG0014573	0	3	0	0	3
OG0014574	0	3	0	0	3
OG0014575	0	3	0	0	3
OG0014576	0	2	0	1	3
OG0014577	0	1	1	1	3
OG0014578	0	3	0	0	3
OG0014579	0	3	0	0	3
OG0014580	0	2	1	0	3
OG0014581	0	2	1	0	3
OG0014582	0	1	2	0	3
OG0014583	0	1	1	1	3
OG0014584	0	1	1	1	3
OG0014585	0	3	0	0	3
OG0014586	0	1	2	0	3
OG0014587	0	3	0	0	3
OG0014588	0	1	2	0	3
OG0014589	0	3	0	0	3
OG0014590	0	3	0	0	3
OG0014591	0	2	1	0	3
OG0014592	0	3	0	0	3
OG0014593	0	2	0	1	3
OG0014594	0	1	2	0	3
OG0014595	0	3	0	0	3
OG0014596	0	3	0	0	3
OG0014597	0	1	1	1	3
OG0014598	0	1	1	1	3
OG0014599	0	3	0	0	3
OG0014600	0	3	0	0	3
OG0014601	0	3	0	0	3
OG0014602	0	1	1	1	3
OG0014603	0	3	0	0	3
OG0014604	0	2	1	0	3
OG0014605	0	3	0	0	3
OG0014606	0	1	2	0	3
OG0014607	0	3	0	0	3
OG0014608	0	2	1	0	3
OG0014609	0	3	0	0	3
OG0014610	0	1	1	1	3
OG0014611	0	1	1	1	3
OG0014612	0	1	1	1	3
OG0014613	0	1	0	2	3
OG0014614	0	1	0	2	3
OG0014615	0	3	0	0	3
OG0014616	0	3	0	0	3
OG0014617	0	3	0	0	3
OG0014618	0	2	0	1	3
OG0014619	0	1	1	1	3
OG0014620	0	1	0	2	3
OG0014621	0	3	0	0	3
OG0014622	0	2	1	0	3
OG0014623	0	3	0	0	3
OG0014624	0	3	0	0	3
OG0014625	0	1	2	0	3
OG0014626	0	3	0	0	3
OG0014627	0	3	0	0	3
OG0014628	0	3	0	0	3
OG0014629	0	3	0	0	3
OG0014630	0	3	0	0	3
OG0014631	0	2	0	1	3
OG0014632	0	1	0	2	3
OG0014633	0	1	0	2	3
OG0014634	0	2	0	1	3
OG0014635	0	3	0	0	3
OG0014636	0	3	0	0	3
OG0014637	0	2	1	0	3
OG0014638	0	3	0	0	3
OG0014639	0	2	0	1	3
OG0014640	0	1	2	0	3
OG0014641	0	3	0	0	3
OG0014642	0	3	0	0	3
OG0014643	0	3	0	0	3
OG0014644	0	0	3	0	3
OG0014645	0	0	3	0	3
OG0014646	0	0	3	0	3
OG0014647	0	0	3	0	3
OG0014648	0	0	3	0	3
OG0014649	0	0	3	0	3
OG0014650	0	0	3	0	3
OG0014651	0	0	3	0	3
OG0014652	0	0	3	0	3
OG0014653	0	0	3	0	3
OG0014654	0	0	3	0	3
OG0014655	0	0	3	0	3
OG0014656	0	0	3	0	3
OG0014657	0	0	3	0	3
OG0014658	0	0	3	0	3
OG0014659	0	0	3	0	3
OG0014660	0	0	3	0	3
OG0014661	0	0	3	0	3
OG0014662	0	0	3	0	3
OG0014663	0	0	3	0	3
OG0014664	0	0	3	0	3
OG0014665	0	0	3	0	3
OG0014666	0	0	3	0	3
OG0014667	0	0	3	0	3
OG0014668	0	0	3	0	3
OG0014669	0	0	3	0	3
OG0014670	0	0	3	0	3
OG0014671	0	0	3	0	3
OG0014672	0	0	3	0	3
OG0014673	0	0	3	0	3
OG0014674	0	0	3	0	3
OG0014675	0	0	3	0	3
OG0014676	0	0	3	0	3
OG0014677	0	0	3	0	3
OG0014678	0	0	3	0	3
OG0014679	0	0	3	0	3
OG0014680	0	0	3	0	3
OG0014681	0	0	3	0	3
OG0014682	0	0	3	0	3
OG0014683	0	0	3	0	3
OG0014684	0	0	3	0	3
OG0014685	0	0	3	0	3
OG0014686	0	0	3	0	3
OG0014687	0	0	3	0	3
OG0014688	0	0	3	0	3
OG0014689	0	0	3	0	3
OG0014690	0	0	3	0	3
OG0014691	0	0	3	0	3
OG0014692	0	0	3	0	3
OG0014693	0	0	3	0	3
OG0014694	0	0	3	0	3
OG0014695	0	0	3	0	3
OG0014696	0	0	3	0	3
OG0014697	0	0	3	0	3
OG0014698	0	0	3	0	3
OG0014699	0	0	3	0	3
OG0014700	0	0	3	0	3
OG0014701	0	0	3	0	3
OG0014702	0	0	3	0	3
OG0014703	0	0	3	0	3
OG0014704	0	0	3	0	3
OG0014705	0	0	3	0	3
OG0014706	0	0	3	0	3
OG0014707	0	0	3	0	3
OG0014708	0	0	3	0	3
OG0014709	0	0	3	0	3
OG0014710	0	0	3	0	3
OG0014711	0	0	3	0	3
OG0014712	0	0	3	0	3
OG0014713	0	0	3	0	3
OG0014714	0	0	3	0	3
OG0014715	0	0	3	0	3
OG0014716	0	0	3	0	3
OG0014717	0	0	3	0	3
OG0014718	0	0	3	0	3
OG0014719	0	0	3	0	3
OG0014720	0	0	3	0	3
OG0014721	0	0	3	0	3
OG0014722	0	0	3	0	3
OG0014723	0	0	3	0	3
OG0014724	0	0	3	0	3
OG0014725	0	0	3	0	3
OG0014726	0	0	3	0	3
OG0014727	0	0	3	0	3
OG0014728	0	0	3	0	3
OG0014729	0	0	3	0	3
OG0014730	0	0	3	0	3
OG0014731	0	0	3	0	3
OG0014732	0	0	3	0	3
OG0014733	0	0	3	0	3
OG0014734	0	0	3	0	3
OG0014735	0	0	3	0	3
OG0014736	0	0	3	0	3
OG0014737	0	0	3	0	3
OG0014738	0	0	3	0	3
OG0014739	0	0	3	0	3
OG0014740	0	0	3	0	3
OG0014741	0	0	3	0	3
OG0014742	0	0	3	0	3
OG0014743	0	0	3	0	3
OG0014744	0	0	3	0	3
OG0014745	0	0	3	0	3
OG0014746	0	0	3	0	3
OG0014747	0	0	3	0	3
OG0014748	0	0	3	0	3
OG0014749	0	0	3	0	3
OG0014750	0	0	3	0	3
OG0014751	0	0	3	0	3
OG0014752	0	0	3	0	3
OG0014753	0	0	3	0	3
OG0014754	0	0	3	0	3
OG0014755	0	0	3	0	3
OG0014756	0	0	3	0	3
OG0014757	0	0	3	0	3
OG0014758	0	0	3	0	3
OG0014759	0	0	3	0	3
OG0014760	0	0	3	0	3
OG0014761	0	0	3	0	3
OG0014762	0	0	3	0	3
OG0014763	0	0	3	0	3
OG0014764	0	0	3	0	3
OG0014765	0	0	3	0	3
OG0014766	0	0	3	0	3
OG0014767	0	0	3	0	3
OG0014768	0	0	3	0	3
OG0014769	0	0	3	0	3
OG0014770	0	0	3	0	3
OG0014771	0	0	3	0	3
OG0014772	0	0	3	0	3
OG0014773	0	0	3	0	3
OG0014774	0	0	3	0	3
OG0014775	0	0	3	0	3
OG0014776	0	0	3	0	3
OG0014777	0	0	3	0	3
OG0014778	0	0	3	0	3
OG0014779	0	0	3	0	3
OG0014780	0	0	3	0	3
OG0014781	0	0	3	0	3
OG0014782	0	0	3	0	3
OG0014783	0	0	3	0	3
OG0014784	0	0	3	0	3
OG0014785	0	0	3	0	3
OG0014786	0	0	3	0	3
OG0014787	0	0	3	0	3
OG0014788	0	0	3	0	3
OG0014789	0	0	3	0	3
OG0014790	0	0	3	0	3
OG0014791	0	0	3	0	3
OG0014792	0	0	3	0	3
OG0014793	0	0	3	0	3
OG0014794	0	0	3	0	3
OG0014795	0	0	3	0	3
OG0014796	0	0	3	0	3
OG0014797	0	0	3	0	3
OG0014798	0	0	3	0	3
OG0014799	0	0	3	0	3
OG0014800	0	0	3	0	3
OG0014801	0	0	3	0	3
OG0014802	0	0	3	0	3
OG0014803	0	0	3	0	3
OG0014804	0	0	3	0	3
OG0014805	0	0	3	0	3
OG0014806	0	0	3	0	3
OG0014807	0	0	3	0	3
OG0014808	0	0	3	0	3
OG0014809	0	0	3	0	3
OG0014810	0	0	3	0	3
OG0014811	0	0	3	0	3
OG0014812	0	0	3	0	3
OG0014813	0	0	3	0	3
OG0014814	0	0	3	0	3
OG0014815	0	0	3	0	3
OG0014816	0	0	3	0	3
OG0014817	0	0	3	0	3
OG0014818	0	0	3	0	3
OG0014819	0	0	3	0	3
OG0014820	0	0	3	0	3
OG0014821	0	0	3	0	3
OG0014822	0	0	3	0	3
OG0014823	0	0	2	1	3
OG0014824	0	0	3	0	3
OG0014825	0	0	3	0	3
OG0014826	0	0	3	0	3
OG0014827	0	0	3	0	3
OG0014828	0	0	3	0	3
OG0014829	0	0	3	0	3
OG0014830	0	0	3	0	3
OG0014831	0	0	3	0	3
OG0014832	0	0	3	0	3
OG0014833	0	0	3	0	3
OG0014834	0	0	3	0	3
OG0014835	0	0	3	0	3
OG0014836	0	0	3	0	3
OG0014837	0	0	3	0	3
OG0014838	0	0	3	0	3
OG0014839	0	0	3	0	3
OG0014840	0	0	3	0	3
OG0014841	0	0	3	0	3
OG0014842	0	0	3	0	3
OG0014843	0	0	3	0	3
OG0014844	0	0	3	0	3
OG0014845	0	0	3	0	3
OG0014846	0	0	3	0	3
OG0014847	0	0	3	0	3
OG0014848	0	0	3	0	3
OG0014849	0	0	3	0	3
OG0014850	0	0	3	0	3
OG0014851	0	0	3	0	3
OG0014852	0	0	3	0	3
OG0014853	0	0	3	0	3
OG0014854	0	0	3	0	3
OG0014855	0	0	3	0	3
OG0014856	0	0	3	0	3
OG0014857	0	0	3	0	3
OG0014858	0	0	3	0	3
OG0014859	0	0	3	0	3
OG0014860	0	0	3	0	3
OG0014861	0	0	3	0	3
OG0014862	0	0	3	0	3
OG0014863	0	0	3	0	3
OG0014864	0	0	3	0	3
OG0014865	0	0	3	0	3
OG0014866	0	0	3	0	3
OG0014867	0	0	3	0	3
OG0014868	0	0	3	0	3
OG0014869	0	0	3	0	3
OG0014870	0	0	3	0	3
OG0014871	0	0	3	0	3
OG0014872	0	0	3	0	3
OG0014873	0	0	3	0	3
OG0014874	0	0	3	0	3
OG0014875	0	0	3	0	3
OG0014876	0	0	3	0	3
OG0014877	0	0	3	0	3
OG0014878	0	0	3	0	3
OG0014879	0	0	3	0	3
OG0014880	0	0	3	0	3
OG0014881	0	0	1	2	3
OG0014882	0	0	3	0	3
OG0014883	0	0	3	0	3
OG0014884	0	0	3	0	3
OG0014885	0	0	3	0	3
OG0014886	0	0	3	0	3
OG0014887	0	0	3	0	3
OG0014888	0	0	3	0	3
OG0014889	0	0	3	0	3
OG0014890	0	0	3	0	3
OG0014891	0	0	3	0	3
OG0014892	0	0	3	0	3
OG0014893	0	0	3	0	3
OG0014894	0	0	3	0	3
OG0014895	0	0	3	0	3
OG0014896	0	0	3	0	3
OG0014897	0	0	3	0	3
OG0014898	0	0	3	0	3
OG0014899	0	0	3	0	3
OG0014900	0	0	3	0	3
OG0014901	0	0	3	0	3
OG0014902	0	0	3	0	3
OG0014903	0	0	3	0	3
OG0014904	0	0	3	0	3
OG0014905	0	0	3	0	3
OG0014906	0	0	3	0	3
OG0014907	0	0	3	0	3
OG0014908	0	0	3	0	3
OG0014909	0	0	3	0	3
OG0014910	0	0	3	0	3
OG0014911	0	0	3	0	3
OG0014912	0	0	3	0	3
OG0014913	0	0	3	0	3
OG0014914	0	0	3	0	3
OG0014915	0	0	3	0	3
OG0014916	0	0	3	0	3
OG0014917	0	0	3	0	3
OG0014918	0	0	3	0	3
OG0014919	0	0	3	0	3
OG0014920	0	0	3	0	3
OG0014921	0	0	3	0	3
OG0014922	0	0	3	0	3
OG0014923	0	0	3	0	3
OG0014924	0	0	3	0	3
OG0014925	0	0	3	0	3
OG0014926	0	0	3	0	3
OG0014927	0	0	3	0	3
OG0014928	0	0	3	0	3
OG0014929	0	0	3	0	3
OG0014930	0	0	3	0	3
OG0014931	0	0	3	0	3
OG0014932	0	0	3	0	3
OG0014933	0	0	3	0	3
OG0014934	0	0	3	0	3
OG0014935	0	0	3	0	3
OG0014936	0	0	3	0	3
OG0014937	0	0	3	0	3
OG0014938	0	0	3	0	3
OG0014939	0	0	3	0	3
OG0014940	0	0	3	0	3
OG0014941	0	0	3	0	3
OG0014942	0	0	3	0	3
OG0014943	0	0	3	0	3
OG0014944	0	0	3	0	3
OG0014945	0	0	3	0	3
OG0014946	0	0	3	0	3
OG0014947	0	0	3	0	3
OG0014948	0	0	3	0	3
OG0014949	0	0	3	0	3
OG0014950	0	0	3	0	3
OG0014951	0	0	3	0	3
OG0014952	0	0	3	0	3
OG0014953	0	0	3	0	3
OG0014954	0	0	3	0	3
OG0014955	0	0	3	0	3
OG0014956	0	0	3	0	3
OG0014957	0	0	3	0	3
OG0014958	0	0	3	0	3
OG0014959	0	0	3	0	3
OG0014960	0	0	3	0	3
OG0014961	0	0	3	0	3
OG0014962	0	0	3	0	3
OG0014963	0	0	3	0	3
OG0014964	0	0	3	0	3
OG0014965	0	0	3	0	3
OG0014966	0	0	3	0	3
OG0014967	0	0	3	0	3
OG0014968	0	0	3	0	3
OG0014969	0	0	3	0	3
OG0014970	0	0	3	0	3
OG0014971	0	0	3	0	3
OG0014972	0	0	3	0	3
OG0014973	0	0	3	0	3
OG0014974	0	0	3	0	3
OG0014975	0	0	3	0	3
OG0014976	0	0	3	0	3
OG0014977	0	0	3	0	3
OG0014978	0	0	3	0	3
OG0014979	0	0	3	0	3
OG0014980	0	0	2	1	3
OG0014981	0	0	3	0	3
OG0014982	0	0	3	0	3
OG0014983	0	0	3	0	3
OG0014984	0	0	3	0	3
OG0014985	0	0	3	0	3
OG0014986	0	0	3	0	3
OG0014987	0	0	3	0	3
OG0014988	0	0	3	0	3
OG0014989	0	0	3	0	3
OG0014990	0	0	3	0	3
OG0014991	0	0	3	0	3
OG0014992	0	0	3	0	3
OG0014993	0	0	3	0	3
OG0014994	0	0	3	0	3
OG0014995	0	0	3	0	3
OG0014996	0	0	3	0	3
OG0014997	0	0	3	0	3
OG0014998	0	0	3	0	3
OG0014999	0	0	3	0	3
OG0015000	0	0	3	0	3
OG0015001	0	0	3	0	3
OG0015002	0	0	3	0	3
OG0015003	0	0	3	0	3
OG0015004	0	0	3	0	3
OG0015005	0	0	3	0	3
OG0015006	0	0	3	0	3
OG0015007	0	0	3	0	3
OG0015008	0	0	3	0	3
OG0015009	0	0	3	0	3
OG0015010	0	0	3	0	3
OG0015011	0	0	3	0	3
OG0015012	0	0	3	0	3
OG0015013	0	0	3	0	3
OG0015014	0	0	3	0	3
OG0015015	0	0	1	2	3
OG0015016	0	0	3	0	3
OG0015017	0	0	3	0	3
OG0015018	0	0	3	0	3
OG0015019	0	0	3	0	3
OG0015020	0	0	3	0	3
OG0015021	0	0	3	0	3
OG0015022	0	0	3	0	3
OG0015023	0	0	3	0	3
OG0015024	0	0	2	1	3
OG0015025	0	0	0	3	3
OG0015026	0	0	0	3	3
OG0015027	0	0	0	3	3
OG0015028	0	0	0	3	3
OG0015029	0	0	0	3	3
OG0015030	0	0	0	3	3
OG0015031	0	0	0	3	3
OG0015032	0	0	0	3	3
OG0015033	0	0	0	3	3
OG0015034	0	0	0	3	3
OG0015035	0	0	0	3	3
OG0015036	0	0	0	3	3
OG0015037	0	0	0	3	3
OG0015038	0	0	0	3	3
OG0015039	0	0	0	3	3
OG0015040	0	0	0	3	3
OG0015041	0	0	0	3	3
OG0015042	0	0	0	3	3
OG0015043	0	0	0	3	3
OG0015044	0	0	0	3	3
OG0015045	0	0	0	3	3
OG0015046	0	0	0	3	3
OG0015047	0	0	0	3	3
OG0015048	0	0	0	3	3
OG0015049	0	0	0	3	3
OG0015050	0	0	0	3	3
OG0015051	0	0	0	3	3
OG0015052	0	0	0	3	3
OG0015053	0	0	0	3	3
OG0015054	0	0	0	3	3
OG0015055	0	0	0	3	3
OG0015056	0	0	0	3	3
OG0015057	0	0	0	3	3
OG0015058	0	0	0	3	3
OG0015059	0	0	0	3	3
OG0015060	0	0	0	3	3
OG0015061	0	0	0	3	3
OG0015062	0	0	0	3	3
OG0015063	0	0	0	3	3
OG0015064	0	0	0	3	3
OG0015065	0	0	0	3	3
OG0015066	0	0	0	3	3
OG0015067	0	0	0	3	3
OG0015068	0	0	0	3	3
OG0015069	0	0	0	3	3
OG0015070	0	0	0	3	3
OG0015071	0	0	0	3	3
OG0015072	0	0	0	3	3
OG0015073	0	0	0	3	3
OG0015074	0	0	0	3	3
OG0015075	0	0	0	3	3
OG0015076	0	0	0	3	3
OG0015077	0	0	0	3	3
OG0015078	0	0	0	3	3
OG0015079	0	0	0	3	3
OG0015080	0	0	0	3	3
OG0015081	0	0	0	3	3
OG0015082	0	0	0	3	3
OG0015083	0	0	0	3	3
OG0015084	0	0	0	3	3
OG0015085	0	0	0	3	3
OG0015086	0	0	0	3	3
OG0015087	0	0	0	3	3
OG0015088	0	0	0	3	3
OG0015089	0	0	0	3	3
OG0015090	0	0	0	3	3
OG0015091	0	0	0	3	3
OG0015092	0	0	0	3	3
OG0015093	0	0	0	3	3
OG0015094	0	0	0	3	3
OG0015095	0	0	0	3	3
OG0015096	0	0	0	3	3
OG0015097	0	0	0	3	3
OG0015098	0	0	0	3	3
OG0015099	0	0	0	3	3
OG0015100	0	0	0	3	3
OG0015101	0	0	0	3	3
OG0015102	0	0	0	3	3
OG0015103	0	0	0	3	3
OG0015104	0	0	0	3	3
OG0015105	0	0	0	3	3
OG0015106	0	0	0	3	3
OG0015107	0	0	0	3	3
OG0015108	0	0	0	3	3
OG0015109	0	0	0	3	3
OG0015110	0	0	0	3	3
OG0015111	0	0	0	3	3
OG0015112	0	0	0	3	3
OG0015113	0	0	0	3	3
OG0015114	0	0	0	3	3
OG0015115	0	0	0	3	3
OG0015116	0	0	0	3	3
OG0015117	0	0	0	3	3
OG0015118	0	0	0	3	3
OG0015119	0	0	0	3	3
OG0015120	0	0	0	3	3
OG0015121	0	0	0	3	3
OG0015122	0	0	0	3	3
OG0015123	0	0	0	3	3
OG0015124	0	0	0	3	3
OG0015125	0	0	0	3	3
OG0015126	0	0	0	3	3
OG0015127	0	0	0	3	3
OG0015128	0	0	0	3	3
OG0015129	0	0	0	3	3
OG0015130	0	0	0	3	3
OG0015131	0	0	0	3	3
OG0015132	0	0	0	3	3
OG0015133	0	0	0	3	3
OG0015134	0	0	0	3	3
OG0015135	0	0	0	3	3
OG0015136	0	0	0	3	3
OG0015137	0	0	0	3	3
OG0015138	0	0	0	3	3
OG0015139	0	0	0	3	3
OG0015140	0	0	0	3	3
OG0015141	0	0	0	3	3
OG0015142	0	0	0	3	3
OG0015143	0	0	0	3	3
OG0015144	0	0	0	3	3
OG0015145	0	0	0	3	3
OG0015146	0	0	0	3	3
OG0015147	0	0	0	3	3
OG0015148	0	0	0	3	3
OG0015149	0	0	0	3	3
OG0015150	0	0	0	3	3
OG0015151	0	0	0	3	3
OG0015152	0	0	0	3	3
OG0015153	0	0	0	3	3
OG0015154	0	0	0	3	3
OG0015155	0	0	0	3	3
OG0015156	0	0	0	3	3
OG0015157	0	0	0	3	3
OG0015158	0	0	0	3	3
OG0015159	0	0	0	3	3
OG0015160	0	0	0	3	3
OG0015161	0	0	0	3	3
OG0015162	0	0	0	3	3
OG0015163	0	0	0	3	3
OG0015164	0	0	0	3	3
OG0015165	0	0	0	3	3
OG0015166	0	0	0	3	3
OG0015167	0	0	0	3	3
OG0015168	0	0	0	3	3
OG0015169	0	0	0	3	3
OG0015170	0	0	0	3	3
OG0015171	0	0	0	3	3
OG0015172	0	0	0	3	3
OG0015173	0	0	0	3	3
OG0015174	0	0	0	3	3
OG0015175	0	0	0	3	3
OG0015176	0	0	0	3	3
OG0015177	0	0	0	3	3
OG0015178	0	0	0	3	3
OG0015179	0	0	0	3	3
OG0015180	0	0	0	3	3
OG0015181	0	0	0	3	3
OG0015182	0	0	0	3	3
OG0015183	0	0	0	3	3
OG0015184	0	0	0	3	3
OG0015185	0	0	0	3	3
OG0015186	0	0	0	3	3
OG0015187	0	0	0	3	3
OG0015188	0	0	0	3	3
OG0015189	0	0	0	3	3
OG0015190	0	0	0	3	3
OG0015191	0	0	0	3	3
OG0015192	0	0	0	3	3
OG0015193	0	0	0	3	3
OG0015194	0	0	0	3	3
OG0015195	0	0	0	3	3
OG0015196	0	0	0	3	3
OG0015197	0	0	0	3	3
OG0015198	0	0	0	3	3
OG0015199	0	0	0	3	3
OG0015200	0	0	0	3	3
OG0015201	0	0	0	3	3
OG0015202	0	0	0	3	3
OG0015203	0	0	0	3	3
OG0015204	0	0	0	3	3
OG0015205	0	0	0	3	3
OG0015206	0	0	0	3	3
OG0015207	0	0	0	3	3
OG0015208	0	0	0	3	3
OG0015209	0	0	0	3	3
OG0015210	0	0	0	3	3
OG0015211	0	0	0	3	3
OG0015212	0	0	0	3	3
OG0015213	0	0	0	3	3
OG0015214	0	0	0	3	3
OG0015215	0	0	0	3	3
OG0015216	0	0	0	3	3
OG0015217	0	0	0	3	3
OG0015218	0	0	0	3	3
OG0015219	0	0	0	3	3
OG0015220	0	0	0	3	3
OG0015221	0	0	0	3	3
OG0015222	0	0	0	3	3
OG0015223	0	0	0	3	3
OG0015224	0	0	0	3	3
OG0015225	0	0	0	3	3
OG0015226	0	0	0	3	3
OG0015227	0	0	0	3	3
OG0015228	0	0	0	3	3
OG0015229	0	0	0	3	3
OG0015230	0	0	0	3	3
OG0015231	0	0	0	3	3
OG0015232	0	0	0	3	3
OG0015233	0	0	0	3	3
OG0015234	0	0	0	3	3
OG0015235	0	0	0	3	3
OG0015236	0	0	0	3	3
OG0015237	0	0	0	3	3
OG0015238	0	0	0	3	3
OG0015239	0	0	0	3	3
OG0015240	0	0	0	3	3
OG0015241	0	0	0	3	3
OG0015242	0	0	0	3	3
OG0015243	0	0	0	3	3
OG0015244	0	0	0	3	3
OG0015245	0	0	0	3	3
OG0015246	0	0	0	3	3
OG0015247	0	0	0	3	3
OG0015248	0	0	0	3	3
OG0015249	0	0	0	3	3
OG0015250	0	0	0	3	3
OG0015251	0	0	0	3	3
OG0015252	0	0	0	3	3
OG0015253	0	0	0	3	3
OG0015254	0	0	0	3	3
OG0015255	0	0	0	3	3
OG0015256	0	0	0	3	3
OG0015257	0	0	0	3	3
OG0015258	0	0	0	3	3
OG0015259	0	0	0	3	3
OG0015260	0	0	0	3	3
OG0015261	0	0	0	3	3
OG0015262	0	0	0	3	3
OG0015263	0	0	0	3	3
OG0015264	0	0	0	3	3
OG0015265	0	0	0	3	3
OG0015266	0	0	0	3	3
OG0015267	0	0	0	3	3
OG0015268	0	0	0	3	3
OG0015269	0	0	0	3	3
OG0015270	0	0	0	3	3
OG0015271	0	0	0	3	3
OG0015272	0	0	0	3	3
OG0015273	0	0	0	3	3
OG0015274	0	0	0	3	3
OG0015275	0	0	0	3	3
OG0015276	0	0	0	3	3
OG0015277	0	0	0	3	3
OG0015278	0	0	0	3	3
OG0015279	0	0	0	3	3
OG0015280	0	0	0	3	3
OG0015281	0	0	0	3	3
OG0015282	0	0	0	3	3
OG0015283	0	0	0	3	3
OG0015284	0	0	0	3	3
OG0015285	0	0	0	3	3
OG0015286	0	0	0	3	3
OG0015287	0	0	0	3	3
OG0015288	0	0	0	3	3
OG0015289	0	0	0	3	3
OG0015290	0	0	0	3	3
OG0015291	0	0	0	3	3
OG0015292	0	0	0	3	3
OG0015293	0	0	0	3	3
OG0015294	0	0	0	3	3
OG0015295	0	0	0	3	3
OG0015296	0	0	0	3	3
OG0015297	0	0	0	3	3
OG0015298	0	0	0	3	3
OG0015299	0	0	0	3	3
OG0015300	0	0	0	3	3
OG0015301	0	0	0	3	3
OG0015302	0	0	0	3	3
OG0015303	0	0	0	3	3
OG0015304	0	0	0	3	3
OG0015305	0	0	0	3	3
OG0015306	0	0	0	3	3
OG0015307	0	0	0	3	3
OG0015308	0	0	0	3	3
OG0015309	0	0	0	3	3
OG0015310	0	0	0	3	3
OG0015311	0	0	0	3	3
OG0015312	0	0	0	3	3
OG0015313	0	0	0	3	3
OG0015314	0	0	0	3	3
OG0015315	0	0	0	3	3
OG0015316	0	0	0	3	3
OG0015317	0	0	0	3	3
OG0015318	0	0	0	3	3
OG0015319	0	0	0	3	3
OG0015320	0	0	0	3	3
OG0015321	0	0	0	3	3
OG0015322	0	0	0	3	3
OG0015323	0	0	0	3	3
OG0015324	0	0	0	3	3
OG0015325	0	0	0	3	3
OG0015326	0	0	0	3	3
OG0015327	0	0	0	3	3
OG0015328	0	0	0	3	3
OG0015329	0	0	0	3	3
OG0015330	0	0	0	3	3
OG0015331	0	0	0	3	3
OG0015332	0	0	0	3	3
OG0015333	0	0	0	3	3
OG0015334	0	0	0	3	3
OG0015335	0	0	0	3	3
OG0015336	0	0	0	3	3
OG0015337	0	0	0	3	3
OG0015338	0	0	0	3	3
OG0015339	0	0	0	3	3
OG0015340	0	0	0	3	3
OG0015341	0	0	0	3	3
OG0015342	0	0	0	3	3
OG0015343	0	0	0	3	3
OG0015344	0	0	0	3	3
OG0015345	0	0	0	3	3
OG0015346	0	0	0	3	3
OG0015347	0	0	0	3	3
OG0015348	0	0	0	3	3
OG0015349	0	0	0	3	3
OG0015350	0	0	0	3	3
OG0015351	0	0	0	3	3
OG0015352	0	0	0	3	3
OG0015353	0	0	0	3	3
OG0015354	0	0	0	3	3
OG0015355	0	0	0	3	3
OG0015356	0	0	0	3	3
OG0015357	0	0	0	3	3
OG0015358	0	0	0	3	3
OG0015359	0	0	0	3	3
OG0015360	0	0	0	3	3
OG0015361	0	0	0	3	3
OG0015362	0	0	0	3	3
OG0015363	0	0	0	3	3
OG0015364	0	0	0	3	3
OG0015365	0	0	0	3	3
OG0015366	0	0	0	3	3
OG0015367	0	0	0	3	3
OG0015368	0	0	0	3	3
OG0015369	0	0	0	3	3
OG0015370	0	0	0	3	3
OG0015371	0	0	0	3	3
OG0015372	0	0	0	3	3
OG0015373	0	0	0	3	3
OG0015374	0	0	0	3	3
OG0015375	0	0	0	3	3
OG0015376	0	0	0	3	3
OG0015377	0	0	0	3	3
OG0015378	0	0	0	3	3
OG0015379	0	0	0	3	3
OG0015380	0	0	0	3	3
OG0015381	0	0	0	3	3
OG0015382	0	0	0	3	3
OG0015383	0	0	0	3	3
OG0015384	0	0	0	3	3
OG0015385	0	0	0	3	3
OG0015386	0	0	0	3	3
OG0015387	0	0	0	3	3
OG0015388	0	0	0	3	3
OG0015389	0	0	0	3	3
OG0015390	0	0	0	3	3
OG0015391	0	0	0	3	3
OG0015392	0	0	0	3	3
OG0015393	0	0	0	3	3
OG0015394	0	0	0	3	3
OG0015395	0	0	0	3	3
OG0015396	0	0	0	3	3
OG0015397	0	0	0	3	3
OG0015398	0	0	0	3	3
OG0015399	0	0	0	3	3
OG0015400	0	0	0	3	3
OG0015401	0	0	0	3	3
OG0015402	0	0	0	3	3
OG0015403	0	0	0	3	3
OG0015404	0	0	0	3	3
OG0015405	0	0	0	3	3
OG0015406	0	0	0	3	3
OG0015407	0	0	0	3	3
OG0015408	0	0	0	3	3
OG0015409	0	0	0	3	3
OG0015410	0	0	0	3	3
OG0015411	0	0	0	3	3
OG0015412	0	0	0	3	3
OG0015413	0	0	0	3	3
OG0015414	0	0	0	3	3
OG0015415	0	0	0	3	3
OG0015416	0	0	0	3	3
OG0015417	0	0	0	3	3
OG0015418	0	0	0	3	3
OG0015419	0	0	0	3	3
OG0015420	0	0	0	3	3
OG0015421	0	0	0	3	3
OG0015422	0	0	0	3	3
OG0015423	0	0	0	3	3
OG0015424	0	0	0	3	3
OG0015425	0	0	0	3	3
OG0015426	0	0	0	3	3
OG0015427	0	0	0	3	3
OG0015428	0	0	0	3	3
OG0015429	0	0	0	3	3
OG0015430	2	0	0	0	2
OG0015431	2	0	0	0	2
OG0015432	2	0	0	0	2
OG0015433	1	0	0	1	2
OG0015434	2	0	0	0	2
OG0015435	2	0	0	0	2
OG0015436	2	0	0	0	2
OG0015437	2	0	0	0	2
OG0015438	2	0	0	0	2
OG0015439	2	0	0	0	2
OG0015440	2	0	0	0	2
OG0015441	2	0	0	0	2
OG0015442	2	0	0	0	2
OG0015443	2	0	0	0	2
OG0015444	2	0	0	0	2
OG0015445	2	0	0	0	2
OG0015446	2	0	0	0	2
OG0015447	2	0	0	0	2
OG0015448	1	0	0	1	2
OG0015449	2	0	0	0	2
OG0015450	2	0	0	0	2
OG0015451	2	0	0	0	2
OG0015452	2	0	0	0	2
OG0015453	1	0	0	1	2
OG0015454	2	0	0	0	2
OG0015455	1	1	0	0	2
OG0015456	2	0	0	0	2
OG0015457	2	0	0	0	2
OG0015458	2	0	0	0	2
OG0015459	2	0	0	0	2
OG0015460	2	0	0	0	2
OG0015461	2	0	0	0	2
OG0015462	2	0	0	0	2
OG0015463	1	0	0	1	2
OG0015464	2	0	0	0	2
OG0015465	1	1	0	0	2
OG0015466	2	0	0	0	2
OG0015467	2	0	0	0	2
OG0015468	2	0	0	0	2
OG0015469	2	0	0	0	2
OG0015470	2	0	0	0	2
OG0015471	1	0	0	1	2
OG0015472	2	0	0	0	2
OG0015473	2	0	0	0	2
OG0015474	2	0	0	0	2
OG0015475	2	0	0	0	2
OG0015476	2	0	0	0	2
OG0015477	2	0	0	0	2
OG0015478	1	0	0	1	2
OG0015479	2	0	0	0	2
OG0015480	1	0	0	1	2
OG0015481	1	0	0	1	2
OG0015482	2	0	0	0	2
OG0015483	2	0	0	0	2
OG0015484	2	0	0	0	2
OG0015485	2	0	0	0	2
OG0015486	2	0	0	0	2
OG0015487	2	0	0	0	2
OG0015488	2	0	0	0	2
OG0015489	2	0	0	0	2
OG0015490	2	0	0	0	2
OG0015491	2	0	0	0	2
OG0015492	1	0	0	1	2
OG0015493	1	1	0	0	2
OG0015494	2	0	0	0	2
OG0015495	1	0	0	1	2
OG0015496	2	0	0	0	2
OG0015497	2	0	0	0	2
OG0015498	2	0	0	0	2
OG0015499	1	0	0	1	2
OG0015500	1	0	0	1	2
OG0015501	2	0	0	0	2
OG0015502	2	0	0	0	2
OG0015503	2	0	0	0	2
OG0015504	2	0	0	0	2
OG0015505	2	0	0	0	2
OG0015506	2	0	0	0	2
OG0015507	1	1	0	0	2
OG0015508	2	0	0	0	2
OG0015509	1	1	0	0	2
OG0015510	2	0	0	0	2
OG0015511	2	0	0	0	2
OG0015512	2	0	0	0	2
OG0015513	1	1	0	0	2
OG0015514	1	0	0	1	2
OG0015515	1	0	0	1	2
OG0015516	2	0	0	0	2
OG0015517	1	0	0	1	2
OG0015518	2	0	0	0	2
OG0015519	2	0	0	0	2
OG0015520	2	0	0	0	2
OG0015521	2	0	0	0	2
OG0015522	2	0	0	0	2
OG0015523	2	0	0	0	2
OG0015524	1	0	0	1	2
OG0015525	2	0	0	0	2
OG0015526	2	0	0	0	2
OG0015527	1	1	0	0	2
OG0015528	2	0	0	0	2
OG0015529	1	0	0	1	2
OG0015530	1	0	0	1	2
OG0015531	2	0	0	0	2
OG0015532	2	0	0	0	2
OG0015533	2	0	0	0	2
OG0015534	2	0	0	0	2
OG0015535	2	0	0	0	2
OG0015536	2	0	0	0	2
OG0015537	2	0	0	0	2
OG0015538	2	0	0	0	2
OG0015539	2	0	0	0	2
OG0015540	1	0	0	1	2
OG0015541	2	0	0	0	2
OG0015542	2	0	0	0	2
OG0015543	1	1	0	0	2
OG0015544	2	0	0	0	2
OG0015545	2	0	0	0	2
OG0015546	2	0	0	0	2
OG0015547	2	0	0	0	2
OG0015548	2	0	0	0	2
OG0015549	1	0	0	1	2
OG0015550	2	0	0	0	2
OG0015551	2	0	0	0	2
OG0015552	2	0	0	0	2
OG0015553	2	0	0	0	2
OG0015554	2	0	0	0	2
OG0015555	2	0	0	0	2
OG0015556	2	0	0	0	2
OG0015557	2	0	0	0	2
OG0015558	2	0	0	0	2
OG0015559	1	0	0	1	2
OG0015560	2	0	0	0	2
OG0015561	2	0	0	0	2
OG0015562	2	0	0	0	2
OG0015563	2	0	0	0	2
OG0015564	1	0	0	1	2
OG0015565	2	0	0	0	2
OG0015566	2	0	0	0	2
OG0015567	2	0	0	0	2
OG0015568	2	0	0	0	2
OG0015569	2	0	0	0	2
OG0015570	1	0	0	1	2
OG0015571	1	0	0	1	2
OG0015572	1	0	0	1	2
OG0015573	1	1	0	0	2
OG0015574	2	0	0	0	2
OG0015575	2	0	0	0	2
OG0015576	2	0	0	0	2
OG0015577	2	0	0	0	2
OG0015578	2	0	0	0	2
OG0015579	2	0	0	0	2
OG0015580	2	0	0	0	2
OG0015581	2	0	0	0	2
OG0015582	2	0	0	0	2
OG0015583	2	0	0	0	2
OG0015584	1	1	0	0	2
OG0015585	2	0	0	0	2
OG0015586	1	0	0	1	2
OG0015587	2	0	0	0	2
OG0015588	2	0	0	0	2
OG0015589	2	0	0	0	2
OG0015590	2	0	0	0	2
OG0015591	2	0	0	0	2
OG0015592	2	0	0	0	2
OG0015593	2	0	0	0	2
OG0015594	2	0	0	0	2
OG0015595	2	0	0	0	2
OG0015596	2	0	0	0	2
OG0015597	2	0	0	0	2
OG0015598	2	0	0	0	2
OG0015599	2	0	0	0	2
OG0015600	2	0	0	0	2
OG0015601	2	0	0	0	2
OG0015602	1	0	0	1	2
OG0015603	2	0	0	0	2
OG0015604	1	1	0	0	2
OG0015605	2	0	0	0	2
OG0015606	2	0	0	0	2
OG0015607	2	0	0	0	2
OG0015608	2	0	0	0	2
OG0015609	2	0	0	0	2
OG0015610	2	0	0	0	2
OG0015611	2	0	0	0	2
OG0015612	2	0	0	0	2
OG0015613	2	0	0	0	2
OG0015614	2	0	0	0	2
OG0015615	2	0	0	0	2
OG0015616	2	0	0	0	2
OG0015617	2	0	0	0	2
OG0015618	2	0	0	0	2
OG0015619	2	0	0	0	2
OG0015620	2	0	0	0	2
OG0015621	2	0	0	0	2
OG0015622	2	0	0	0	2
OG0015623	2	0	0	0	2
OG0015624	2	0	0	0	2
OG0015625	1	0	0	1	2
OG0015626	2	0	0	0	2
OG0015627	2	0	0	0	2
OG0015628	1	0	0	1	2
OG0015629	2	0	0	0	2
OG0015630	2	0	0	0	2
OG0015631	1	0	0	1	2
OG0015632	2	0	0	0	2
OG0015633	2	0	0	0	2
OG0015634	2	0	0	0	2
OG0015635	2	0	0	0	2
OG0015636	1	0	0	1	2
OG0015637	2	0	0	0	2
OG0015638	2	0	0	0	2
OG0015639	2	0	0	0	2
OG0015640	1	1	0	0	2
OG0015641	1	0	0	1	2
OG0015642	1	0	0	1	2
OG0015643	2	0	0	0	2
OG0015644	1	0	0	1	2
OG0015645	2	0	0	0	2
OG0015646	2	0	0	0	2
OG0015647	2	0	0	0	2
OG0015648	1	1	0	0	2
OG0015649	2	0	0	0	2
OG0015650	2	0	0	0	2
OG0015651	2	0	0	0	2
OG0015652	2	0	0	0	2
OG0015653	2	0	0	0	2
OG0015654	2	0	0	0	2
OG0015655	2	0	0	0	2
OG0015656	2	0	0	0	2
OG0015657	2	0	0	0	2
OG0015658	2	0	0	0	2
OG0015659	1	0	0	1	2
OG0015660	2	0	0	0	2
OG0015661	2	0	0	0	2
OG0015662	2	0	0	0	2
OG0015663	2	0	0	0	2
OG0015664	1	0	0	1	2
OG0015665	1	0	0	1	2
OG0015666	2	0	0	0	2
OG0015667	2	0	0	0	2
OG0015668	2	0	0	0	2
OG0015669	1	0	0	1	2
OG0015670	2	0	0	0	2
OG0015671	2	0	0	0	2
OG0015672	2	0	0	0	2
OG0015673	2	0	0	0	2
OG0015674	1	0	0	1	2
OG0015675	2	0	0	0	2
OG0015676	1	0	0	1	2
OG0015677	2	0	0	0	2
OG0015678	2	0	0	0	2
OG0015679	1	0	0	1	2
OG0015680	2	0	0	0	2
OG0015681	1	0	0	1	2
OG0015682	1	1	0	0	2
OG0015683	2	0	0	0	2
OG0015684	2	0	0	0	2
OG0015685	2	0	0	0	2
OG0015686	2	0	0	0	2
OG0015687	2	0	0	0	2
OG0015688	2	0	0	0	2
OG0015689	1	0	0	1	2
OG0015690	2	0	0	0	2
OG0015691	2	0	0	0	2
OG0015692	2	0	0	0	2
OG0015693	1	0	0	1	2
OG0015694	2	0	0	0	2
OG0015695	2	0	0	0	2
OG0015696	2	0	0	0	2
OG0015697	2	0	0	0	2
OG0015698	2	0	0	0	2
OG0015699	2	0	0	0	2
OG0015700	1	0	0	1	2
OG0015701	2	0	0	0	2
OG0015702	2	0	0	0	2
OG0015703	2	0	0	0	2
OG0015704	2	0	0	0	2
OG0015705	2	0	0	0	2
OG0015706	2	0	0	0	2
OG0015707	2	0	0	0	2
OG0015708	1	0	0	1	2
OG0015709	2	0	0	0	2
OG0015710	2	0	0	0	2
OG0015711	2	0	0	0	2
OG0015712	2	0	0	0	2
OG0015713	2	0	0	0	2
OG0015714	2	0	0	0	2
OG0015715	1	0	0	1	2
OG0015716	2	0	0	0	2
OG0015717	2	0	0	0	2
OG0015718	2	0	0	0	2
OG0015719	1	0	0	1	2
OG0015720	2	0	0	0	2
OG0015721	2	0	0	0	2
OG0015722	2	0	0	0	2
OG0015723	2	0	0	0	2
OG0015724	1	0	0	1	2
OG0015725	2	0	0	0	2
OG0015726	2	0	0	0	2
OG0015727	2	0	0	0	2
OG0015728	2	0	0	0	2
OG0015729	2	0	0	0	2
OG0015730	2	0	0	0	2
OG0015731	1	0	0	1	2
OG0015732	2	0	0	0	2
OG0015733	1	0	0	1	2
OG0015734	2	0	0	0	2
OG0015735	1	0	0	1	2
OG0015736	2	0	0	0	2
OG0015737	2	0	0	0	2
OG0015738	1	0	0	1	2
OG0015739	2	0	0	0	2
OG0015740	2	0	0	0	2
OG0015741	2	0	0	0	2
OG0015742	1	0	0	1	2
OG0015743	2	0	0	0	2
OG0015744	1	0	0	1	2
OG0015745	2	0	0	0	2
OG0015746	2	0	0	0	2
OG0015747	1	1	0	0	2
OG0015748	2	0	0	0	2
OG0015749	2	0	0	0	2
OG0015750	2	0	0	0	2
OG0015751	2	0	0	0	2
OG0015752	2	0	0	0	2
OG0015753	2	0	0	0	2
OG0015754	1	1	0	0	2
OG0015755	2	0	0	0	2
OG0015756	2	0	0	0	2
OG0015757	2	0	0	0	2
OG0015758	2	0	0	0	2
OG0015759	1	1	0	0	2
OG0015760	1	0	0	1	2
OG0015761	2	0	0	0	2
OG0015762	2	0	0	0	2
OG0015763	1	1	0	0	2
OG0015764	1	0	0	1	2
OG0015765	1	0	0	1	2
OG0015766	1	0	0	1	2
OG0015767	2	0	0	0	2
OG0015768	2	0	0	0	2
OG0015769	2	0	0	0	2
OG0015770	2	0	0	0	2
OG0015771	2	0	0	0	2
OG0015772	2	0	0	0	2
OG0015773	2	0	0	0	2
OG0015774	1	0	0	1	2
OG0015775	2	0	0	0	2
OG0015776	1	0	0	1	2
OG0015777	2	0	0	0	2
OG0015778	1	1	0	0	2
OG0015779	2	0	0	0	2
OG0015780	1	0	0	1	2
OG0015781	2	0	0	0	2
OG0015782	2	0	0	0	2
OG0015783	1	0	0	1	2
OG0015784	1	0	0	1	2
OG0015785	2	0	0	0	2
OG0015786	2	0	0	0	2
OG0015787	2	0	0	0	2
OG0015788	1	0	0	1	2
OG0015789	2	0	0	0	2
OG0015790	2	0	0	0	2
OG0015791	2	0	0	0	2
OG0015792	2	0	0	0	2
OG0015793	2	0	0	0	2
OG0015794	2	0	0	0	2
OG0015795	1	0	0	1	2
OG0015796	2	0	0	0	2
OG0015797	2	0	0	0	2
OG0015798	1	0	0	1	2
OG0015799	2	0	0	0	2
OG0015800	1	1	0	0	2
OG0015801	2	0	0	0	2
OG0015802	2	0	0	0	2
OG0015803	2	0	0	0	2
OG0015804	2	0	0	0	2
OG0015805	2	0	0	0	2
OG0015806	1	1	0	0	2
OG0015807	1	0	0	1	2
OG0015808	1	1	0	0	2
OG0015809	2	0	0	0	2
OG0015810	2	0	0	0	2
OG0015811	2	0	0	0	2
OG0015812	1	0	0	1	2
OG0015813	2	0	0	0	2
OG0015814	1	0	0	1	2
OG0015815	2	0	0	0	2
OG0015816	2	0	0	0	2
OG0015817	2	0	0	0	2
OG0015818	2	0	0	0	2
OG0015819	2	0	0	0	2
OG0015820	2	0	0	0	2
OG0015821	2	0	0	0	2
OG0015822	2	0	0	0	2
OG0015823	2	0	0	0	2
OG0015824	1	0	0	1	2
OG0015825	1	1	0	0	2
OG0015826	1	0	0	1	2
OG0015827	1	0	0	1	2
OG0015828	2	0	0	0	2
OG0015829	2	0	0	0	2
OG0015830	2	0	0	0	2
OG0015831	2	0	0	0	2
OG0015832	2	0	0	0	2
OG0015833	1	0	0	1	2
OG0015834	2	0	0	0	2
OG0015835	2	0	0	0	2
OG0015836	1	0	0	1	2
OG0015837	1	0	0	1	2
OG0015838	2	0	0	0	2
OG0015839	1	0	0	1	2
OG0015840	2	0	0	0	2
OG0015841	2	0	0	0	2
OG0015842	1	0	0	1	2
OG0015843	2	0	0	0	2
OG0015844	2	0	0	0	2
OG0015845	2	0	0	0	2
OG0015846	2	0	0	0	2
OG0015847	1	0	1	0	2
OG0015848	1	1	0	0	2
OG0015849	1	0	0	1	2
OG0015850	2	0	0	0	2
OG0015851	2	0	0	0	2
OG0015852	1	0	0	1	2
OG0015853	1	1	0	0	2
OG0015854	1	0	0	1	2
OG0015855	2	0	0	0	2
OG0015856	2	0	0	0	2
OG0015857	2	0	0	0	2
OG0015858	2	0	0	0	2
OG0015859	2	0	0	0	2
OG0015860	2	0	0	0	2
OG0015861	2	0	0	0	2
OG0015862	2	0	0	0	2
OG0015863	2	0	0	0	2
OG0015864	2	0	0	0	2
OG0015865	2	0	0	0	2
OG0015866	2	0	0	0	2
OG0015867	1	0	0	1	2
OG0015868	2	0	0	0	2
OG0015869	1	0	0	1	2
OG0015870	2	0	0	0	2
OG0015871	1	0	0	1	2
OG0015872	1	0	0	1	2
OG0015873	2	0	0	0	2
OG0015874	2	0	0	0	2
OG0015875	1	0	0	1	2
OG0015876	2	0	0	0	2
OG0015877	2	0	0	0	2
OG0015878	2	0	0	0	2
OG0015879	2	0	0	0	2
OG0015880	2	0	0	0	2
OG0015881	2	0	0	0	2
OG0015882	1	0	0	1	2
OG0015883	2	0	0	0	2
OG0015884	2	0	0	0	2
OG0015885	2	0	0	0	2
OG0015886	2	0	0	0	2
OG0015887	2	0	0	0	2
OG0015888	2	0	0	0	2
OG0015889	2	0	0	0	2
OG0015890	1	0	0	1	2
OG0015891	1	0	0	1	2
OG0015892	1	0	0	1	2
OG0015893	2	0	0	0	2
OG0015894	2	0	0	0	2
OG0015895	2	0	0	0	2
OG0015896	2	0	0	0	2
OG0015897	2	0	0	0	2
OG0015898	2	0	0	0	2
OG0015899	2	0	0	0	2
OG0015900	2	0	0	0	2
OG0015901	1	0	0	1	2
OG0015902	2	0	0	0	2
OG0015903	2	0	0	0	2
OG0015904	2	0	0	0	2
OG0015905	2	0	0	0	2
OG0015906	2	0	0	0	2
OG0015907	2	0	0	0	2
OG0015908	1	0	0	1	2
OG0015909	1	0	0	1	2
OG0015910	2	0	0	0	2
OG0015911	2	0	0	0	2
OG0015912	2	0	0	0	2
OG0015913	2	0	0	0	2
OG0015914	1	0	0	1	2
OG0015915	1	0	0	1	2
OG0015916	2	0	0	0	2
OG0015917	2	0	0	0	2
OG0015918	2	0	0	0	2
OG0015919	2	0	0	0	2
OG0015920	2	0	0	0	2
OG0015921	2	0	0	0	2
OG0015922	2	0	0	0	2
OG0015923	2	0	0	0	2
OG0015924	2	0	0	0	2
OG0015925	2	0	0	0	2
OG0015926	1	0	0	1	2
OG0015927	2	0	0	0	2
OG0015928	1	1	0	0	2
OG0015929	2	0	0	0	2
OG0015930	2	0	0	0	2
OG0015931	2	0	0	0	2
OG0015932	1	1	0	0	2
OG0015933	2	0	0	0	2
OG0015934	2	0	0	0	2
OG0015935	2	0	0	0	2
OG0015936	2	0	0	0	2
OG0015937	2	0	0	0	2
OG0015938	2	0	0	0	2
OG0015939	2	0	0	0	2
OG0015940	2	0	0	0	2
OG0015941	2	0	0	0	2
OG0015942	1	0	0	1	2
OG0015943	2	0	0	0	2
OG0015944	2	0	0	0	2
OG0015945	1	0	0	1	2
OG0015946	2	0	0	0	2
OG0015947	2	0	0	0	2
OG0015948	2	0	0	0	2
OG0015949	2	0	0	0	2
OG0015950	2	0	0	0	2
OG0015951	2	0	0	0	2
OG0015952	2	0	0	0	2
OG0015953	2	0	0	0	2
OG0015954	2	0	0	0	2
OG0015955	2	0	0	0	2
OG0015956	2	0	0	0	2
OG0015957	2	0	0	0	2
OG0015958	2	0	0	0	2
OG0015959	2	0	0	0	2
OG0015960	2	0	0	0	2
OG0015961	1	0	0	1	2
OG0015962	2	0	0	0	2
OG0015963	2	0	0	0	2
OG0015964	2	0	0	0	2
OG0015965	2	0	0	0	2
OG0015966	1	0	0	1	2
OG0015967	2	0	0	0	2
OG0015968	2	0	0	0	2
OG0015969	2	0	0	0	2
OG0015970	1	0	0	1	2
OG0015971	1	1	0	0	2
OG0015972	2	0	0	0	2
OG0015973	2	0	0	0	2
OG0015974	1	0	0	1	2
OG0015975	1	0	0	1	2
OG0015976	2	0	0	0	2
OG0015977	2	0	0	0	2
OG0015978	2	0	0	0	2
OG0015979	2	0	0	0	2
OG0015980	2	0	0	0	2
OG0015981	1	1	0	0	2
OG0015982	2	0	0	0	2
OG0015983	2	0	0	0	2
OG0015984	2	0	0	0	2
OG0015985	2	0	0	0	2
OG0015986	2	0	0	0	2
OG0015987	2	0	0	0	2
OG0015988	2	0	0	0	2
OG0015989	2	0	0	0	2
OG0015990	2	0	0	0	2
OG0015991	1	0	0	1	2
OG0015992	2	0	0	0	2
OG0015993	2	0	0	0	2
OG0015994	2	0	0	0	2
OG0015995	2	0	0	0	2
OG0015996	2	0	0	0	2
OG0015997	2	0	0	0	2
OG0015998	2	0	0	0	2
OG0015999	1	1	0	0	2
OG0016000	2	0	0	0	2
OG0016001	2	0	0	0	2
OG0016002	1	0	0	1	2
OG0016003	2	0	0	0	2
OG0016004	2	0	0	0	2
OG0016005	2	0	0	0	2
OG0016006	2	0	0	0	2
OG0016007	2	0	0	0	2
OG0016008	1	1	0	0	2
OG0016009	2	0	0	0	2
OG0016010	2	0	0	0	2
OG0016011	2	0	0	0	2
OG0016012	2	0	0	0	2
OG0016013	2	0	0	0	2
OG0016014	2	0	0	0	2
OG0016015	2	0	0	0	2
OG0016016	2	0	0	0	2
OG0016017	2	0	0	0	2
OG0016018	2	0	0	0	2
OG0016019	1	0	0	1	2
OG0016020	2	0	0	0	2
OG0016021	2	0	0	0	2
OG0016022	2	0	0	0	2
OG0016023	2	0	0	0	2
OG0016024	1	1	0	0	2
OG0016025	2	0	0	0	2
OG0016026	2	0	0	0	2
OG0016027	2	0	0	0	2
OG0016028	2	0	0	0	2
OG0016029	1	1	0	0	2
OG0016030	2	0	0	0	2
OG0016031	2	0	0	0	2
OG0016032	2	0	0	0	2
OG0016033	1	0	0	1	2
OG0016034	2	0	0	0	2
OG0016035	1	0	0	1	2
OG0016036	2	0	0	0	2
OG0016037	2	0	0	0	2
OG0016038	1	0	0	1	2
OG0016039	2	0	0	0	2
OG0016040	2	0	0	0	2
OG0016041	2	0	0	0	2
OG0016042	2	0	0	0	2
OG0016043	2	0	0	0	2
OG0016044	2	0	0	0	2
OG0016045	2	0	0	0	2
OG0016046	2	0	0	0	2
OG0016047	1	0	0	1	2
OG0016048	2	0	0	0	2
OG0016049	1	0	0	1	2
OG0016050	2	0	0	0	2
OG0016051	2	0	0	0	2
OG0016052	1	0	0	1	2
OG0016053	1	1	0	0	2
OG0016054	2	0	0	0	2
OG0016055	1	0	0	1	2
OG0016056	2	0	0	0	2
OG0016057	2	0	0	0	2
OG0016058	2	0	0	0	2
OG0016059	2	0	0	0	2
OG0016060	1	0	0	1	2
OG0016061	2	0	0	0	2
OG0016062	1	0	0	1	2
OG0016063	2	0	0	0	2
OG0016064	2	0	0	0	2
OG0016065	2	0	0	0	2
OG0016066	2	0	0	0	2
OG0016067	1	1	0	0	2
OG0016068	2	0	0	0	2
OG0016069	2	0	0	0	2
OG0016070	2	0	0	0	2
OG0016071	2	0	0	0	2
OG0016072	2	0	0	0	2
OG0016073	2	0	0	0	2
OG0016074	2	0	0	0	2
OG0016075	2	0	0	0	2
OG0016076	2	0	0	0	2
OG0016077	2	0	0	0	2
OG0016078	2	0	0	0	2
OG0016079	1	0	0	1	2
OG0016080	1	0	0	1	2
OG0016081	2	0	0	0	2
OG0016082	1	0	0	1	2
OG0016083	2	0	0	0	2
OG0016084	2	0	0	0	2
OG0016085	2	0	0	0	2
OG0016086	2	0	0	0	2
OG0016087	2	0	0	0	2
OG0016088	2	0	0	0	2
OG0016089	1	0	0	1	2
OG0016090	2	0	0	0	2
OG0016091	2	0	0	0	2
OG0016092	1	0	0	1	2
OG0016093	2	0	0	0	2
OG0016094	1	0	0	1	2
OG0016095	2	0	0	0	2
OG0016096	2	0	0	0	2
OG0016097	2	0	0	0	2
OG0016098	2	0	0	0	2
OG0016099	2	0	0	0	2
OG0016100	2	0	0	0	2
OG0016101	2	0	0	0	2
OG0016102	2	0	0	0	2
OG0016103	1	0	0	1	2
OG0016104	2	0	0	0	2
OG0016105	2	0	0	0	2
OG0016106	1	1	0	0	2
OG0016107	2	0	0	0	2
OG0016108	2	0	0	0	2
OG0016109	2	0	0	0	2
OG0016110	1	0	0	1	2
OG0016111	2	0	0	0	2
OG0016112	2	0	0	0	2
OG0016113	2	0	0	0	2
OG0016114	2	0	0	0	2
OG0016115	2	0	0	0	2
OG0016116	2	0	0	0	2
OG0016117	2	0	0	0	2
OG0016118	2	0	0	0	2
OG0016119	2	0	0	0	2
OG0016120	2	0	0	0	2
OG0016121	2	0	0	0	2
OG0016122	2	0	0	0	2
OG0016123	2	0	0	0	2
OG0016124	2	0	0	0	2
OG0016125	2	0	0	0	2
OG0016126	2	0	0	0	2
OG0016127	1	0	0	1	2
OG0016128	2	0	0	0	2
OG0016129	2	0	0	0	2
OG0016130	2	0	0	0	2
OG0016131	1	0	0	1	2
OG0016132	2	0	0	0	2
OG0016133	2	0	0	0	2
OG0016134	1	0	0	1	2
OG0016135	2	0	0	0	2
OG0016136	2	0	0	0	2
OG0016137	2	0	0	0	2
OG0016138	2	0	0	0	2
OG0016139	1	0	0	1	2
OG0016140	2	0	0	0	2
OG0016141	2	0	0	0	2
OG0016142	2	0	0	0	2
OG0016143	2	0	0	0	2
OG0016144	2	0	0	0	2
OG0016145	1	0	0	1	2
OG0016146	1	0	0	1	2
OG0016147	2	0	0	0	2
OG0016148	1	0	0	1	2
OG0016149	2	0	0	0	2
OG0016150	2	0	0	0	2
OG0016151	2	0	0	0	2
OG0016152	2	0	0	0	2
OG0016153	2	0	0	0	2
OG0016154	2	0	0	0	2
OG0016155	2	0	0	0	2
OG0016156	1	1	0	0	2
OG0016157	1	0	0	1	2
OG0016158	1	0	0	1	2
OG0016159	1	0	0	1	2
OG0016160	1	0	0	1	2
OG0016161	2	0	0	0	2
OG0016162	1	0	0	1	2
OG0016163	2	0	0	0	2
OG0016164	1	0	0	1	2
OG0016165	2	0	0	0	2
OG0016166	2	0	0	0	2
OG0016167	1	0	0	1	2
OG0016168	2	0	0	0	2
OG0016169	1	0	0	1	2
OG0016170	2	0	0	0	2
OG0016171	2	0	0	0	2
OG0016172	1	0	0	1	2
OG0016173	2	0	0	0	2
OG0016174	2	0	0	0	2
OG0016175	2	0	0	0	2
OG0016176	2	0	0	0	2
OG0016177	2	0	0	0	2
OG0016178	2	0	0	0	2
OG0016179	2	0	0	0	2
OG0016180	2	0	0	0	2
OG0016181	2	0	0	0	2
OG0016182	2	0	0	0	2
OG0016183	2	0	0	0	2
OG0016184	2	0	0	0	2
OG0016185	2	0	0	0	2
OG0016186	2	0	0	0	2
OG0016187	2	0	0	0	2
OG0016188	1	0	0	1	2
OG0016189	1	0	0	1	2
OG0016190	2	0	0	0	2
OG0016191	1	0	0	1	2
OG0016192	2	0	0	0	2
OG0016193	2	0	0	0	2
OG0016194	1	0	0	1	2
OG0016195	2	0	0	0	2
OG0016196	1	0	0	1	2
OG0016197	1	0	0	1	2
OG0016198	2	0	0	0	2
OG0016199	2	0	0	0	2
OG0016200	1	0	0	1	2
OG0016201	1	0	0	1	2
OG0016202	2	0	0	0	2
OG0016203	1	1	0	0	2
OG0016204	1	0	0	1	2
OG0016205	1	0	0	1	2
OG0016206	2	0	0	0	2
OG0016207	1	0	0	1	2
OG0016208	2	0	0	0	2
OG0016209	2	0	0	0	2
OG0016210	2	0	0	0	2
OG0016211	1	1	0	0	2
OG0016212	1	1	0	0	2
OG0016213	2	0	0	0	2
OG0016214	2	0	0	0	2
OG0016215	2	0	0	0	2
OG0016216	2	0	0	0	2
OG0016217	1	1	0	0	2
OG0016218	2	0	0	0	2
OG0016219	2	0	0	0	2
OG0016220	1	0	0	1	2
OG0016221	2	0	0	0	2
OG0016222	2	0	0	0	2
OG0016223	2	0	0	0	2
OG0016224	1	0	0	1	2
OG0016225	2	0	0	0	2
OG0016226	1	1	0	0	2
OG0016227	2	0	0	0	2
OG0016228	1	0	0	1	2
OG0016229	2	0	0	0	2
OG0016230	1	1	0	0	2
OG0016231	2	0	0	0	2
OG0016232	2	0	0	0	2
OG0016233	2	0	0	0	2
OG0016234	2	0	0	0	2
OG0016235	2	0	0	0	2
OG0016236	2	0	0	0	2
OG0016237	1	0	0	1	2
OG0016238	2	0	0	0	2
OG0016239	2	0	0	0	2
OG0016240	2	0	0	0	2
OG0016241	1	0	0	1	2
OG0016242	1	0	0	1	2
OG0016243	2	0	0	0	2
OG0016244	2	0	0	0	2
OG0016245	2	0	0	0	2
OG0016246	2	0	0	0	2
OG0016247	2	0	0	0	2
OG0016248	2	0	0	0	2
OG0016249	1	0	0	1	2
OG0016250	2	0	0	0	2
OG0016251	2	0	0	0	2
OG0016252	2	0	0	0	2
OG0016253	1	0	0	1	2
OG0016254	1	0	0	1	2
OG0016255	2	0	0	0	2
OG0016256	2	0	0	0	2
OG0016257	2	0	0	0	2
OG0016258	2	0	0	0	2
OG0016259	2	0	0	0	2
OG0016260	2	0	0	0	2
OG0016261	1	0	0	1	2
OG0016262	2	0	0	0	2
OG0016263	2	0	0	0	2
OG0016264	2	0	0	0	2
OG0016265	2	0	0	0	2
OG0016266	2	0	0	0	2
OG0016267	1	0	0	1	2
OG0016268	2	0	0	0	2
OG0016269	2	0	0	0	2
OG0016270	2	0	0	0	2
OG0016271	2	0	0	0	2
OG0016272	2	0	0	0	2
OG0016273	1	0	0	1	2
OG0016274	2	0	0	0	2
OG0016275	2	0	0	0	2
OG0016276	2	0	0	0	2
OG0016277	2	0	0	0	2
OG0016278	2	0	0	0	2
OG0016279	1	0	0	1	2
OG0016280	2	0	0	0	2
OG0016281	2	0	0	0	2
OG0016282	2	0	0	0	2
OG0016283	1	0	0	1	2
OG0016284	2	0	0	0	2
OG0016285	2	0	0	0	2
OG0016286	1	0	0	1	2
OG0016287	2	0	0	0	2
OG0016288	1	0	0	1	2
OG0016289	1	0	0	1	2
OG0016290	2	0	0	0	2
OG0016291	2	0	0	0	2
OG0016292	2	0	0	0	2
OG0016293	1	0	0	1	2
OG0016294	2	0	0	0	2
OG0016295	1	0	0	1	2
OG0016296	2	0	0	0	2
OG0016297	2	0	0	0	2
OG0016298	1	1	0	0	2
OG0016299	1	1	0	0	2
OG0016300	2	0	0	0	2
OG0016301	2	0	0	0	2
OG0016302	2	0	0	0	2
OG0016303	2	0	0	0	2
OG0016304	2	0	0	0	2
OG0016305	2	0	0	0	2
OG0016306	2	0	0	0	2
OG0016307	2	0	0	0	2
OG0016308	2	0	0	0	2
OG0016309	1	0	0	1	2
OG0016310	1	0	0	1	2
OG0016311	2	0	0	0	2
OG0016312	2	0	0	0	2
OG0016313	1	0	0	1	2
OG0016314	1	0	0	1	2
OG0016315	2	0	0	0	2
OG0016316	2	0	0	0	2
OG0016317	2	0	0	0	2
OG0016318	2	0	0	0	2
OG0016319	1	0	0	1	2
OG0016320	1	0	0	1	2
OG0016321	2	0	0	0	2
OG0016322	1	0	0	1	2
OG0016323	2	0	0	0	2
OG0016324	2	0	0	0	2
OG0016325	2	0	0	0	2
OG0016326	1	0	0	1	2
OG0016327	2	0	0	0	2
OG0016328	1	0	0	1	2
OG0016329	2	0	0	0	2
OG0016330	1	0	1	0	2
OG0016331	2	0	0	0	2
OG0016332	1	0	0	1	2
OG0016333	1	0	0	1	2
OG0016334	1	1	0	0	2
OG0016335	2	0	0	0	2
OG0016336	2	0	0	0	2
OG0016337	2	0	0	0	2
OG0016338	2	0	0	0	2
OG0016339	1	0	0	1	2
OG0016340	2	0	0	0	2
OG0016341	2	0	0	0	2
OG0016342	2	0	0	0	2
OG0016343	1	0	0	1	2
OG0016344	2	0	0	0	2
OG0016345	2	0	0	0	2
OG0016346	2	0	0	0	2
OG0016347	2	0	0	0	2
OG0016348	2	0	0	0	2
OG0016349	2	0	0	0	2
OG0016350	2	0	0	0	2
OG0016351	2	0	0	0	2
OG0016352	1	0	0	1	2
OG0016353	2	0	0	0	2
OG0016354	1	0	0	1	2
OG0016355	2	0	0	0	2
OG0016356	2	0	0	0	2
OG0016357	2	0	0	0	2
OG0016358	2	0	0	0	2
OG0016359	2	0	0	0	2
OG0016360	2	0	0	0	2
OG0016361	1	0	0	1	2
OG0016362	2	0	0	0	2
OG0016363	2	0	0	0	2
OG0016364	1	0	0	1	2
OG0016365	2	0	0	0	2
OG0016366	2	0	0	0	2
OG0016367	2	0	0	0	2
OG0016368	2	0	0	0	2
OG0016369	2	0	0	0	2
OG0016370	1	0	0	1	2
OG0016371	1	0	0	1	2
OG0016372	1	0	0	1	2
OG0016373	2	0	0	0	2
OG0016374	1	0	0	1	2
OG0016375	2	0	0	0	2
OG0016376	2	0	0	0	2
OG0016377	2	0	0	0	2
OG0016378	2	0	0	0	2
OG0016379	1	0	0	1	2
OG0016380	2	0	0	0	2
OG0016381	2	0	0	0	2
OG0016382	2	0	0	0	2
OG0016383	2	0	0	0	2
OG0016384	2	0	0	0	2
OG0016385	2	0	0	0	2
OG0016386	2	0	0	0	2
OG0016387	2	0	0	0	2
OG0016388	2	0	0	0	2
OG0016389	1	0	0	1	2
OG0016390	2	0	0	0	2
OG0016391	2	0	0	0	2
OG0016392	1	0	0	1	2
OG0016393	1	0	0	1	2
OG0016394	2	0	0	0	2
OG0016395	2	0	0	0	2
OG0016396	2	0	0	0	2
OG0016397	2	0	0	0	2
OG0016398	2	0	0	0	2
OG0016399	2	0	0	0	2
OG0016400	2	0	0	0	2
OG0016401	2	0	0	0	2
OG0016402	2	0	0	0	2
OG0016403	2	0	0	0	2
OG0016404	2	0	0	0	2
OG0016405	1	0	0	1	2
OG0016406	2	0	0	0	2
OG0016407	1	0	0	1	2
OG0016408	2	0	0	0	2
OG0016409	2	0	0	0	2
OG0016410	2	0	0	0	2
OG0016411	2	0	0	0	2
OG0016412	1	0	0	1	2
OG0016413	1	0	0	1	2
OG0016414	1	0	0	1	2
OG0016415	2	0	0	0	2
OG0016416	2	0	0	0	2
OG0016417	1	0	0	1	2
OG0016418	1	0	0	1	2
OG0016419	2	0	0	0	2
OG0016420	2	0	0	0	2
OG0016421	2	0	0	0	2
OG0016422	1	0	0	1	2
OG0016423	2	0	0	0	2
OG0016424	2	0	0	0	2
OG0016425	2	0	0	0	2
OG0016426	2	0	0	0	2
OG0016427	2	0	0	0	2
OG0016428	1	0	0	1	2
OG0016429	2	0	0	0	2
OG0016430	2	0	0	0	2
OG0016431	2	0	0	0	2
OG0016432	1	1	0	0	2
OG0016433	2	0	0	0	2
OG0016434	2	0	0	0	2
OG0016435	1	0	0	1	2
OG0016436	2	0	0	0	2
OG0016437	2	0	0	0	2
OG0016438	2	0	0	0	2
OG0016439	1	0	0	1	2
OG0016440	2	0	0	0	2
OG0016441	2	0	0	0	2
OG0016442	2	0	0	0	2
OG0016443	2	0	0	0	2
OG0016444	1	0	0	1	2
OG0016445	2	0	0	0	2
OG0016446	1	0	1	0	2
OG0016447	2	0	0	0	2
OG0016448	2	0	0	0	2
OG0016449	1	0	0	1	2
OG0016450	2	0	0	0	2
OG0016451	2	0	0	0	2
OG0016452	1	0	0	1	2
OG0016453	2	0	0	0	2
OG0016454	1	0	0	1	2
OG0016455	1	0	0	1	2
OG0016456	1	0	0	1	2
OG0016457	1	0	0	1	2
OG0016458	1	0	0	1	2
OG0016459	2	0	0	0	2
OG0016460	2	0	0	0	2
OG0016461	2	0	0	0	2
OG0016462	1	0	0	1	2
OG0016463	2	0	0	0	2
OG0016464	1	0	0	1	2
OG0016465	2	0	0	0	2
OG0016466	2	0	0	0	2
OG0016467	2	0	0	0	2
OG0016468	2	0	0	0	2
OG0016469	2	0	0	0	2
OG0016470	1	0	0	1	2
OG0016471	2	0	0	0	2
OG0016472	2	0	0	0	2
OG0016473	1	1	0	0	2
OG0016474	2	0	0	0	2
OG0016475	2	0	0	0	2
OG0016476	2	0	0	0	2
OG0016477	2	0	0	0	2
OG0016478	1	0	0	1	2
OG0016479	1	0	0	1	2
OG0016480	2	0	0	0	2
OG0016481	1	0	0	1	2
OG0016482	2	0	0	0	2
OG0016483	1	0	0	1	2
OG0016484	2	0	0	0	2
OG0016485	2	0	0	0	2
OG0016486	2	0	0	0	2
OG0016487	1	0	0	1	2
OG0016488	2	0	0	0	2
OG0016489	2	0	0	0	2
OG0016490	2	0	0	0	2
OG0016491	1	0	0	1	2
OG0016492	1	0	0	1	2
OG0016493	2	0	0	0	2
OG0016494	2	0	0	0	2
OG0016495	2	0	0	0	2
OG0016496	1	0	0	1	2
OG0016497	1	0	0	1	2
OG0016498	1	0	0	1	2
OG0016499	2	0	0	0	2
OG0016500	2	0	0	0	2
OG0016501	2	0	0	0	2
OG0016502	1	0	0	1	2
OG0016503	1	0	1	0	2
OG0016504	2	0	0	0	2
OG0016505	2	0	0	0	2
OG0016506	1	0	0	1	2
OG0016507	2	0	0	0	2
OG0016508	2	0	0	0	2
OG0016509	2	0	0	0	2
OG0016510	1	0	0	1	2
OG0016511	2	0	0	0	2
OG0016512	2	0	0	0	2
OG0016513	1	0	0	1	2
OG0016514	2	0	0	0	2
OG0016515	1	0	0	1	2
OG0016516	1	0	0	1	2
OG0016517	1	0	0	1	2
OG0016518	1	0	0	1	2
OG0016519	2	0	0	0	2
OG0016520	2	0	0	0	2
OG0016521	2	0	0	0	2
OG0016522	1	0	0	1	2
OG0016523	2	0	0	0	2
OG0016524	2	0	0	0	2
OG0016525	2	0	0	0	2
OG0016526	1	0	0	1	2
OG0016527	1	0	0	1	2
OG0016528	1	0	0	1	2
OG0016529	1	0	0	1	2
OG0016530	2	0	0	0	2
OG0016531	2	0	0	0	2
OG0016532	1	0	0	1	2
OG0016533	2	0	0	0	2
OG0016534	2	0	0	0	2
OG0016535	1	0	0	1	2
OG0016536	1	0	0	1	2
OG0016537	2	0	0	0	2
OG0016538	1	0	0	1	2
OG0016539	1	0	0	1	2
OG0016540	2	0	0	0	2
OG0016541	1	0	0	1	2
OG0016542	1	0	0	1	2
OG0016543	2	0	0	0	2
OG0016544	2	0	0	0	2
OG0016545	1	0	0	1	2
OG0016546	2	0	0	0	2
OG0016547	1	0	0	1	2
OG0016548	2	0	0	0	2
OG0016549	1	0	0	1	2
OG0016550	2	0	0	0	2
OG0016551	1	0	0	1	2
OG0016552	1	1	0	0	2
OG0016553	1	0	0	1	2
OG0016554	2	0	0	0	2
OG0016555	2	0	0	0	2
OG0016556	1	0	0	1	2
OG0016557	1	0	0	1	2
OG0016558	2	0	0	0	2
OG0016559	2	0	0	0	2
OG0016560	2	0	0	0	2
OG0016561	2	0	0	0	2
OG0016562	1	0	0	1	2
OG0016563	1	0	0	1	2
OG0016564	2	0	0	0	2
OG0016565	1	0	0	1	2
OG0016566	1	0	0	1	2
OG0016567	2	0	0	0	2
OG0016568	2	0	0	0	2
OG0016569	1	0	0	1	2
OG0016570	1	0	0	1	2
OG0016571	2	0	0	0	2
OG0016572	1	0	0	1	2
OG0016573	2	0	0	0	2
OG0016574	1	0	0	1	2
OG0016575	1	0	0	1	2
OG0016576	1	0	0	1	2
OG0016577	1	0	0	1	2
OG0016578	1	0	0	1	2
OG0016579	1	0	0	1	2
OG0016580	2	0	0	0	2
OG0016581	2	0	0	0	2
OG0016582	2	0	0	0	2
OG0016583	1	0	0	1	2
OG0016584	1	0	0	1	2
OG0016585	2	0	0	0	2
OG0016586	2	0	0	0	2
OG0016587	1	0	0	1	2
OG0016588	2	0	0	0	2
OG0016589	2	0	0	0	2
OG0016590	1	0	0	1	2
OG0016591	1	0	0	1	2
OG0016592	2	0	0	0	2
OG0016593	2	0	0	0	2
OG0016594	2	0	0	0	2
OG0016595	2	0	0	0	2
OG0016596	2	0	0	0	2
OG0016597	1	0	0	1	2
OG0016598	2	0	0	0	2
OG0016599	2	0	0	0	2
OG0016600	2	0	0	0	2
OG0016601	1	0	0	1	2
OG0016602	1	0	0	1	2
OG0016603	2	0	0	0	2
OG0016604	1	0	1	0	2
OG0016605	1	0	0	1	2
OG0016606	2	0	0	0	2
OG0016607	2	0	0	0	2
OG0016608	2	0	0	0	2
OG0016609	1	0	0	1	2
OG0016610	1	0	0	1	2
OG0016611	1	0	0	1	2
OG0016612	1	0	0	1	2
OG0016613	1	0	0	1	2
OG0016614	2	0	0	0	2
OG0016615	1	1	0	0	2
OG0016616	1	0	0	1	2
OG0016617	1	0	0	1	2
OG0016618	2	0	0	0	2
OG0016619	2	0	0	0	2
OG0016620	2	0	0	0	2
OG0016621	1	0	0	1	2
OG0016622	2	0	0	0	2
OG0016623	1	0	0	1	2
OG0016624	2	0	0	0	2
OG0016625	1	0	1	0	2
OG0016626	2	0	0	0	2
OG0016627	2	0	0	0	2
OG0016628	1	0	0	1	2
OG0016629	1	0	0	1	2
OG0016630	1	0	0	1	2
OG0016631	2	0	0	0	2
OG0016632	1	0	0	1	2
OG0016633	1	0	0	1	2
OG0016634	1	0	0	1	2
OG0016635	1	0	0	1	2
OG0016636	2	0	0	0	2
OG0016637	2	0	0	0	2
OG0016638	2	0	0	0	2
OG0016639	2	0	0	0	2
OG0016640	1	0	0	1	2
OG0016641	2	0	0	0	2
OG0016642	2	0	0	0	2
OG0016643	2	0	0	0	2
OG0016644	2	0	0	0	2
OG0016645	1	0	0	1	2
OG0016646	1	0	0	1	2
OG0016647	2	0	0	0	2
OG0016648	1	0	0	1	2
OG0016649	1	0	0	1	2
OG0016650	1	0	0	1	2
OG0016651	2	0	0	0	2
OG0016652	2	0	0	0	2
OG0016653	1	0	0	1	2
OG0016654	2	0	0	0	2
OG0016655	2	0	0	0	2
OG0016656	2	0	0	0	2
OG0016657	1	0	0	1	2
OG0016658	2	0	0	0	2
OG0016659	1	0	0	1	2
OG0016660	2	0	0	0	2
OG0016661	1	0	0	1	2
OG0016662	1	0	0	1	2
OG0016663	1	0	0	1	2
OG0016664	2	0	0	0	2
OG0016665	2	0	0	0	2
OG0016666	1	0	0	1	2
OG0016667	2	0	0	0	2
OG0016668	1	0	0	1	2
OG0016669	2	0	0	0	2
OG0016670	2	0	0	0	2
OG0016671	2	0	0	0	2
OG0016672	1	1	0	0	2
OG0016673	1	0	0	1	2
OG0016674	2	0	0	0	2
OG0016675	2	0	0	0	2
OG0016676	2	0	0	0	2
OG0016677	1	0	0	1	2
OG0016678	1	1	0	0	2
OG0016679	1	0	0	1	2
OG0016680	2	0	0	0	2
OG0016681	1	0	0	1	2
OG0016682	2	0	0	0	2
OG0016683	1	0	0	1	2
OG0016684	2	0	0	0	2
OG0016685	2	0	0	0	2
OG0016686	2	0	0	0	2
OG0016687	1	0	0	1	2
OG0016688	1	0	0	1	2
OG0016689	1	0	0	1	2
OG0016690	1	0	0	1	2
OG0016691	2	0	0	0	2
OG0016692	1	0	0	1	2
OG0016693	1	0	0	1	2
OG0016694	1	0	0	1	2
OG0016695	1	0	0	1	2
OG0016696	2	0	0	0	2
OG0016697	1	0	0	1	2
OG0016698	1	0	0	1	2
OG0016699	2	0	0	0	2
OG0016700	1	0	0	1	2
OG0016701	2	0	0	0	2
OG0016702	1	1	0	0	2
OG0016703	1	0	0	1	2
OG0016704	2	0	0	0	2
OG0016705	1	0	0	1	2
OG0016706	2	0	0	0	2
OG0016707	1	0	0	1	2
OG0016708	2	0	0	0	2
OG0016709	2	0	0	0	2
OG0016710	2	0	0	0	2
OG0016711	1	0	0	1	2
OG0016712	1	0	0	1	2
OG0016713	2	0	0	0	2
OG0016714	2	0	0	0	2
OG0016715	2	0	0	0	2
OG0016716	2	0	0	0	2
OG0016717	1	0	0	1	2
OG0016718	2	0	0	0	2
OG0016719	1	0	0	1	2
OG0016720	1	0	0	1	2
OG0016721	1	0	0	1	2
OG0016722	1	0	0	1	2
OG0016723	1	0	0	1	2
OG0016724	1	0	0	1	2
OG0016725	1	0	0	1	2
OG0016726	2	0	0	0	2
OG0016727	1	0	0	1	2
OG0016728	1	0	0	1	2
OG0016729	2	0	0	0	2
OG0016730	1	0	0	1	2
OG0016731	1	0	0	1	2
OG0016732	1	0	0	1	2
OG0016733	1	0	0	1	2
OG0016734	1	0	0	1	2
OG0016735	2	0	0	0	2
OG0016736	1	0	0	1	2
OG0016737	1	0	0	1	2
OG0016738	1	0	0	1	2
OG0016739	1	0	0	1	2
OG0016740	1	0	0	1	2
OG0016741	2	0	0	0	2
OG0016742	1	0	0	1	2
OG0016743	1	0	0	1	2
OG0016744	1	0	0	1	2
OG0016745	1	0	0	1	2
OG0016746	2	0	0	0	2
OG0016747	1	0	0	1	2
OG0016748	2	0	0	0	2
OG0016749	1	0	0	1	2
OG0016750	1	0	0	1	2
OG0016751	1	0	0	1	2
OG0016752	1	0	0	1	2
OG0016753	2	0	0	0	2
OG0016754	2	0	0	0	2
OG0016755	1	0	0	1	2
OG0016756	1	0	0	1	2
OG0016757	1	0	0	1	2
OG0016758	2	0	0	0	2
OG0016759	1	0	0	1	2
OG0016760	2	0	0	0	2
OG0016761	1	0	0	1	2
OG0016762	1	0	0	1	2
OG0016763	1	0	0	1	2
OG0016764	1	0	0	1	2
OG0016765	2	0	0	0	2
OG0016766	1	0	0	1	2
OG0016767	1	1	0	0	2
OG0016768	1	0	0	1	2
OG0016769	1	0	0	1	2
OG0016770	2	0	0	0	2
OG0016771	2	0	0	0	2
OG0016772	2	0	0	0	2
OG0016773	1	0	0	1	2
OG0016774	1	0	0	1	2
OG0016775	2	0	0	0	2
OG0016776	2	0	0	0	2
OG0016777	1	0	0	1	2
OG0016778	2	0	0	0	2
OG0016779	2	0	0	0	2
OG0016780	2	0	0	0	2
OG0016781	1	0	0	1	2
OG0016782	2	0	0	0	2
OG0016783	1	0	0	1	2
OG0016784	1	1	0	0	2
OG0016785	1	0	0	1	2
OG0016786	2	0	0	0	2
OG0016787	2	0	0	0	2
OG0016788	1	0	0	1	2
OG0016789	1	0	0	1	2
OG0016790	1	0	0	1	2
OG0016791	2	0	0	0	2
OG0016792	1	0	0	1	2
OG0016793	2	0	0	0	2
OG0016794	2	0	0	0	2
OG0016795	2	0	0	0	2
OG0016796	1	0	0	1	2
OG0016797	1	0	0	1	2
OG0016798	2	0	0	0	2
OG0016799	1	0	0	1	2
OG0016800	1	0	0	1	2
OG0016801	1	0	0	1	2
OG0016802	1	0	0	1	2
OG0016803	2	0	0	0	2
OG0016804	1	0	0	1	2
OG0016805	2	0	0	0	2
OG0016806	1	0	0	1	2
OG0016807	1	0	0	1	2
OG0016808	1	0	0	1	2
OG0016809	1	0	0	1	2
OG0016810	1	0	0	1	2
OG0016811	2	0	0	0	2
OG0016812	1	1	0	0	2
OG0016813	1	0	0	1	2
OG0016814	1	0	0	1	2
OG0016815	2	0	0	0	2
OG0016816	2	0	0	0	2
OG0016817	2	0	0	0	2
OG0016818	1	0	0	1	2
OG0016819	1	0	0	1	2
OG0016820	1	0	0	1	2
OG0016821	1	0	0	1	2
OG0016822	1	0	0	1	2
OG0016823	1	0	0	1	2
OG0016824	1	0	1	0	2
OG0016825	1	0	0	1	2
OG0016826	1	0	0	1	2
OG0016827	1	0	0	1	2
OG0016828	1	0	0	1	2
OG0016829	1	0	0	1	2
OG0016830	1	0	0	1	2
OG0016831	1	0	0	1	2
OG0016832	2	0	0	0	2
OG0016833	2	0	0	0	2
OG0016834	1	0	0	1	2
OG0016835	1	0	0	1	2
OG0016836	1	0	0	1	2
OG0016837	1	0	0	1	2
OG0016838	2	0	0	0	2
OG0016839	1	0	0	1	2
OG0016840	1	0	0	1	2
OG0016841	2	0	0	0	2
OG0016842	1	0	0	1	2
OG0016843	1	0	0	1	2
OG0016844	2	0	0	0	2
OG0016845	2	0	0	0	2
OG0016846	1	0	0	1	2
OG0016847	1	0	0	1	2
OG0016848	1	0	0	1	2
OG0016849	1	0	0	1	2
OG0016850	1	0	0	1	2
OG0016851	1	1	0	0	2
OG0016852	1	0	0	1	2
OG0016853	1	0	0	1	2
OG0016854	1	0	0	1	2
OG0016855	1	0	0	1	2
OG0016856	1	0	0	1	2
OG0016857	1	0	0	1	2
OG0016858	1	0	0	1	2
OG0016859	2	0	0	0	2
OG0016860	1	0	0	1	2
OG0016861	2	0	0	0	2
OG0016862	2	0	0	0	2
OG0016863	1	0	0	1	2
OG0016864	1	0	0	1	2
OG0016865	1	0	0	1	2
OG0016866	2	0	0	0	2
OG0016867	2	0	0	0	2
OG0016868	2	0	0	0	2
OG0016869	2	0	0	0	2
OG0016870	1	0	0	1	2
OG0016871	1	0	0	1	2
OG0016872	1	0	0	1	2
OG0016873	1	0	0	1	2
OG0016874	1	0	0	1	2
OG0016875	1	0	0	1	2
OG0016876	1	0	0	1	2
OG0016877	2	0	0	0	2
OG0016878	1	0	0	1	2
OG0016879	2	0	0	0	2
OG0016880	2	0	0	0	2
OG0016881	2	0	0	0	2
OG0016882	2	0	0	0	2
OG0016883	2	0	0	0	2
OG0016884	2	0	0	0	2
OG0016885	1	0	0	1	2
OG0016886	1	0	0	1	2
OG0016887	2	0	0	0	2
OG0016888	2	0	0	0	2
OG0016889	1	0	0	1	2
OG0016890	1	0	1	0	2
OG0016891	1	0	0	1	2
OG0016892	2	0	0	0	2
OG0016893	1	0	0	1	2
OG0016894	1	0	0	1	2
OG0016895	1	0	0	1	2
OG0016896	2	0	0	0	2
OG0016897	1	0	0	1	2
OG0016898	2	0	0	0	2
OG0016899	2	0	0	0	2
OG0016900	1	0	0	1	2
OG0016901	1	0	0	1	2
OG0016902	2	0	0	0	2
OG0016903	2	0	0	0	2
OG0016904	1	0	0	1	2
OG0016905	1	0	0	1	2
OG0016906	1	0	0	1	2
OG0016907	1	1	0	0	2
OG0016908	1	0	0	1	2
OG0016909	1	1	0	0	2
OG0016910	2	0	0	0	2
OG0016911	2	0	0	0	2
OG0016912	1	0	0	1	2
OG0016913	1	0	0	1	2
OG0016914	2	0	0	0	2
OG0016915	1	0	0	1	2
OG0016916	2	0	0	0	2
OG0016917	2	0	0	0	2
OG0016918	2	0	0	0	2
OG0016919	2	0	0	0	2
OG0016920	1	0	0	1	2
OG0016921	1	0	0	1	2
OG0016922	2	0	0	0	2
OG0016923	2	0	0	0	2
OG0016924	2	0	0	0	2
OG0016925	1	0	0	1	2
OG0016926	1	0	0	1	2
OG0016927	2	0	0	0	2
OG0016928	1	0	0	1	2
OG0016929	2	0	0	0	2
OG0016930	2	0	0	0	2
OG0016931	2	0	0	0	2
OG0016932	2	0	0	0	2
OG0016933	1	0	0	1	2
OG0016934	2	0	0	0	2
OG0016935	1	0	0	1	2
OG0016936	1	0	0	1	2
OG0016937	1	1	0	0	2
OG0016938	2	0	0	0	2
OG0016939	1	0	0	1	2
OG0016940	1	0	0	1	2
OG0016941	1	0	0	1	2
OG0016942	2	0	0	0	2
OG0016943	1	1	0	0	2
OG0016944	1	0	0	1	2
OG0016945	2	0	0	0	2
OG0016946	1	0	0	1	2
OG0016947	2	0	0	0	2
OG0016948	1	0	0	1	2
OG0016949	1	0	0	1	2
OG0016950	1	0	0	1	2
OG0016951	1	0	0	1	2
OG0016952	2	0	0	0	2
OG0016953	2	0	0	0	2
OG0016954	1	0	0	1	2
OG0016955	2	0	0	0	2
OG0016956	1	0	0	1	2
OG0016957	1	0	1	0	2
OG0016958	1	0	0	1	2
OG0016959	1	0	0	1	2
OG0016960	1	0	0	1	2
OG0016961	2	0	0	0	2
OG0016962	1	0	0	1	2
OG0016963	1	0	0	1	2
OG0016964	2	0	0	0	2
OG0016965	1	0	0	1	2
OG0016966	1	0	0	1	2
OG0016967	1	0	0	1	2
OG0016968	1	0	0	1	2
OG0016969	1	0	0	1	2
OG0016970	1	0	0	1	2
OG0016971	2	0	0	0	2
OG0016972	2	0	0	0	2
OG0016973	1	0	0	1	2
OG0016974	1	0	0	1	2
OG0016975	2	0	0	0	2
OG0016976	1	0	0	1	2
OG0016977	2	0	0	0	2
OG0016978	1	0	1	0	2
OG0016979	1	0	0	1	2
OG0016980	2	0	0	0	2
OG0016981	1	0	0	1	2
OG0016982	2	0	0	0	2
OG0016983	1	0	0	1	2
OG0016984	1	0	0	1	2
OG0016985	1	0	0	1	2
OG0016986	1	0	0	1	2
OG0016987	1	0	0	1	2
OG0016988	1	0	0	1	2
OG0016989	1	0	0	1	2
OG0016990	1	0	0	1	2
OG0016991	1	0	0	1	2
OG0016992	1	0	0	1	2
OG0016993	1	0	0	1	2
OG0016994	1	0	0	1	2
OG0016995	1	0	0	1	2
OG0016996	1	0	0	1	2
OG0016997	2	0	0	0	2
OG0016998	1	0	0	1	2
OG0016999	1	0	0	1	2
OG0017000	1	0	0	1	2
OG0017001	1	0	0	1	2
OG0017002	1	0	0	1	2
OG0017003	1	0	0	1	2
OG0017004	2	0	0	0	2
OG0017005	2	0	0	0	2
OG0017006	1	0	0	1	2
OG0017007	1	0	0	1	2
OG0017008	2	0	0	0	2
OG0017009	1	0	0	1	2
OG0017010	2	0	0	0	2
OG0017011	1	0	0	1	2
OG0017012	1	0	0	1	2
OG0017013	1	0	0	1	2
OG0017014	1	0	0	1	2
OG0017015	2	0	0	0	2
OG0017016	2	0	0	0	2
OG0017017	1	0	0	1	2
OG0017018	1	0	0	1	2
OG0017019	1	0	0	1	2
OG0017020	1	0	0	1	2
OG0017021	1	0	0	1	2
OG0017022	1	0	0	1	2
OG0017023	1	0	0	1	2
OG0017024	1	0	0	1	2
OG0017025	1	0	0	1	2
OG0017026	2	0	0	0	2
OG0017027	1	0	0	1	2
OG0017028	1	0	0	1	2
OG0017029	1	0	0	1	2
OG0017030	1	0	0	1	2
OG0017031	1	0	0	1	2
OG0017032	1	0	0	1	2
OG0017033	1	0	0	1	2
OG0017034	1	0	0	1	2
OG0017035	1	0	0	1	2
OG0017036	1	0	0	1	2
OG0017037	1	0	0	1	2
OG0017038	1	0	0	1	2
OG0017039	1	0	0	1	2
OG0017040	1	0	0	1	2
OG0017041	1	0	0	1	2
OG0017042	1	0	0	1	2
OG0017043	1	0	0	1	2
OG0017044	1	0	0	1	2
OG0017045	1	0	0	1	2
OG0017046	1	0	0	1	2
OG0017047	1	0	0	1	2
OG0017048	1	0	0	1	2
OG0017049	2	0	0	0	2
OG0017050	1	0	0	1	2
OG0017051	1	0	0	1	2
OG0017052	1	0	0	1	2
OG0017053	1	0	0	1	2
OG0017054	1	0	0	1	2
OG0017055	1	0	0	1	2
OG0017056	2	0	0	0	2
OG0017057	1	0	0	1	2
OG0017058	1	0	0	1	2
OG0017059	2	0	0	0	2
OG0017060	2	0	0	0	2
OG0017061	1	0	0	1	2
OG0017062	2	0	0	0	2
OG0017063	1	0	0	1	2
OG0017064	2	0	0	0	2
OG0017065	1	0	0	1	2
OG0017066	2	0	0	0	2
OG0017067	1	0	0	1	2
OG0017068	1	0	0	1	2
OG0017069	1	1	0	0	2
OG0017070	1	0	0	1	2
OG0017071	2	0	0	0	2
OG0017072	1	0	0	1	2
OG0017073	1	0	0	1	2
OG0017074	1	0	0	1	2
OG0017075	1	0	0	1	2
OG0017076	1	0	0	1	2
OG0017077	1	0	0	1	2
OG0017078	1	0	0	1	2
OG0017079	1	0	0	1	2
OG0017080	1	0	0	1	2
OG0017081	1	0	0	1	2
OG0017082	2	0	0	0	2
OG0017083	1	0	0	1	2
OG0017084	1	0	0	1	2
OG0017085	2	0	0	0	2
OG0017086	1	0	0	1	2
OG0017087	2	0	0	0	2
OG0017088	2	0	0	0	2
OG0017089	2	0	0	0	2
OG0017090	2	0	0	0	2
OG0017091	1	1	0	0	2
OG0017092	2	0	0	0	2
OG0017093	1	0	0	1	2
OG0017094	2	0	0	0	2
OG0017095	2	0	0	0	2
OG0017096	1	0	0	1	2
OG0017097	1	0	0	1	2
OG0017098	2	0	0	0	2
OG0017099	1	0	0	1	2
OG0017100	1	1	0	0	2
OG0017101	1	0	1	0	2
OG0017102	1	0	0	1	2
OG0017103	1	0	0	1	2
OG0017104	1	0	1	0	2
OG0017105	2	0	0	0	2
OG0017106	1	0	0	1	2
OG0017107	2	0	0	0	2
OG0017108	1	0	0	1	2
OG0017109	1	0	0	1	2
OG0017110	1	0	0	1	2
OG0017111	1	0	0	1	2
OG0017112	1	0	0	1	2
OG0017113	1	0	0	1	2
OG0017114	1	0	0	1	2
OG0017115	1	0	0	1	2
OG0017116	1	0	0	1	2
OG0017117	1	0	0	1	2
OG0017118	1	0	0	1	2
OG0017119	1	0	0	1	2
OG0017120	1	0	0	1	2
OG0017121	1	0	0	1	2
OG0017122	1	0	0	1	2
OG0017123	2	0	0	0	2
OG0017124	1	0	0	1	2
OG0017125	1	0	0	1	2
OG0017126	1	0	0	1	2
OG0017127	1	0	0	1	2
OG0017128	1	0	0	1	2
OG0017129	1	0	0	1	2
OG0017130	1	0	0	1	2
OG0017131	1	1	0	0	2
OG0017132	1	0	0	1	2
OG0017133	1	0	0	1	2
OG0017134	1	0	0	1	2
OG0017135	2	0	0	0	2
OG0017136	1	0	0	1	2
OG0017137	1	0	0	1	2
OG0017138	1	0	0	1	2
OG0017139	1	0	0	1	2
OG0017140	1	0	0	1	2
OG0017141	1	0	0	1	2
OG0017142	1	0	0	1	2
OG0017143	1	0	0	1	2
OG0017144	1	0	0	1	2
OG0017145	1	0	0	1	2
OG0017146	1	0	0	1	2
OG0017147	1	0	0	1	2
OG0017148	1	0	0	1	2
OG0017149	2	0	0	0	2
OG0017150	1	0	0	1	2
OG0017151	1	0	0	1	2
OG0017152	1	0	0	1	2
OG0017153	1	0	0	1	2
OG0017154	1	0	0	1	2
OG0017155	1	0	0	1	2
OG0017156	1	0	0	1	2
OG0017157	1	0	0	1	2
OG0017158	1	0	0	1	2
OG0017159	1	0	0	1	2
OG0017160	1	0	0	1	2
OG0017161	1	0	0	1	2
OG0017162	1	0	0	1	2
OG0017163	2	0	0	0	2
OG0017164	1	0	0	1	2
OG0017165	1	0	0	1	2
OG0017166	1	0	0	1	2
OG0017167	1	0	0	1	2
OG0017168	1	0	0	1	2
OG0017169	1	0	0	1	2
OG0017170	1	0	0	1	2
OG0017171	1	0	0	1	2
OG0017172	1	0	0	1	2
OG0017173	2	0	0	0	2
OG0017174	2	0	0	0	2
OG0017175	1	0	0	1	2
OG0017176	1	0	0	1	2
OG0017177	1	0	0	1	2
OG0017178	1	0	0	1	2
OG0017179	1	0	0	1	2
OG0017180	2	0	0	0	2
OG0017181	2	0	0	0	2
OG0017182	1	0	0	1	2
OG0017183	2	0	0	0	2
OG0017184	1	0	0	1	2
OG0017185	2	0	0	0	2
OG0017186	1	0	0	1	2
OG0017187	1	0	0	1	2
OG0017188	2	0	0	0	2
OG0017189	1	0	0	1	2
OG0017190	2	0	0	0	2
OG0017191	2	0	0	0	2
OG0017192	2	0	0	0	2
OG0017193	2	0	0	0	2
OG0017194	1	0	0	1	2
OG0017195	1	0	0	1	2
OG0017196	2	0	0	0	2
OG0017197	2	0	0	0	2
OG0017198	1	0	0	1	2
OG0017199	2	0	0	0	2
OG0017200	2	0	0	0	2
OG0017201	2	0	0	0	2
OG0017202	1	0	0	1	2
OG0017203	1	0	0	1	2
OG0017204	1	0	0	1	2
OG0017205	1	0	0	1	2
OG0017206	2	0	0	0	2
OG0017207	1	0	0	1	2
OG0017208	1	0	0	1	2
OG0017209	1	0	0	1	2
OG0017210	1	0	0	1	2
OG0017211	2	0	0	0	2
OG0017212	1	0	0	1	2
OG0017213	2	0	0	0	2
OG0017214	2	0	0	0	2
OG0017215	2	0	0	0	2
OG0017216	1	0	0	1	2
OG0017217	1	0	0	1	2
OG0017218	1	0	0	1	2
OG0017219	1	0	0	1	2
OG0017220	1	0	0	1	2
OG0017221	1	0	0	1	2
OG0017222	1	0	0	1	2
OG0017223	1	0	0	1	2
OG0017224	1	0	0	1	2
OG0017225	1	0	0	1	2
OG0017226	1	0	0	1	2
OG0017227	2	0	0	0	2
OG0017228	1	0	0	1	2
OG0017229	1	0	0	1	2
OG0017230	1	0	0	1	2
OG0017231	1	1	0	0	2
OG0017232	1	0	0	1	2
OG0017233	1	0	0	1	2
OG0017234	2	0	0	0	2
OG0017235	1	0	0	1	2
OG0017236	1	0	0	1	2
OG0017237	1	0	0	1	2
OG0017238	1	0	0	1	2
OG0017239	1	0	0	1	2
OG0017240	1	0	0	1	2
OG0017241	1	0	0	1	2
OG0017242	1	0	0	1	2
OG0017243	2	0	0	0	2
OG0017244	1	0	0	1	2
OG0017245	1	0	0	1	2
OG0017246	1	0	0	1	2
OG0017247	2	0	0	0	2
OG0017248	1	0	0	1	2
OG0017249	1	0	0	1	2
OG0017250	2	0	0	0	2
OG0017251	2	0	0	0	2
OG0017252	1	0	1	0	2
OG0017253	1	0	0	1	2
OG0017254	2	0	0	0	2
OG0017255	1	0	0	1	2
OG0017256	1	0	0	1	2
OG0017257	1	0	0	1	2
OG0017258	1	0	0	1	2
OG0017259	1	0	0	1	2
OG0017260	1	0	0	1	2
OG0017261	2	0	0	0	2
OG0017262	1	0	0	1	2
OG0017263	1	0	0	1	2
OG0017264	1	1	0	0	2
OG0017265	2	0	0	0	2
OG0017266	1	0	0	1	2
OG0017267	1	0	0	1	2
OG0017268	1	0	0	1	2
OG0017269	2	0	0	0	2
OG0017270	1	0	0	1	2
OG0017271	1	0	0	1	2
OG0017272	1	0	0	1	2
OG0017273	1	0	0	1	2
OG0017274	1	0	0	1	2
OG0017275	2	0	0	0	2
OG0017276	1	0	0	1	2
OG0017277	1	0	0	1	2
OG0017278	1	0	0	1	2
OG0017279	2	0	0	0	2
OG0017280	1	0	0	1	2
OG0017281	2	0	0	0	2
OG0017282	1	1	0	0	2
OG0017283	1	0	0	1	2
OG0017284	2	0	0	0	2
OG0017285	1	0	0	1	2
OG0017286	1	0	0	1	2
OG0017287	1	0	0	1	2
OG0017288	1	0	0	1	2
OG0017289	1	0	0	1	2
OG0017290	2	0	0	0	2
OG0017291	2	0	0	0	2
OG0017292	1	0	0	1	2
OG0017293	1	1	0	0	2
OG0017294	2	0	0	0	2
OG0017295	1	0	0	1	2
OG0017296	1	0	0	1	2
OG0017297	1	0	0	1	2
OG0017298	2	0	0	0	2
OG0017299	1	0	0	1	2
OG0017300	1	0	0	1	2
OG0017301	2	0	0	0	2
OG0017302	1	0	0	1	2
OG0017303	2	0	0	0	2
OG0017304	1	0	0	1	2
OG0017305	1	0	0	1	2
OG0017306	1	0	0	1	2
OG0017307	1	0	0	1	2
OG0017308	1	0	0	1	2
OG0017309	1	0	0	1	2
OG0017310	1	0	0	1	2
OG0017311	1	0	0	1	2
OG0017312	1	0	0	1	2
OG0017313	2	0	0	0	2
OG0017314	2	0	0	0	2
OG0017315	2	0	0	0	2
OG0017316	1	0	0	1	2
OG0017317	1	0	0	1	2
OG0017318	2	0	0	0	2
OG0017319	2	0	0	0	2
OG0017320	1	0	0	1	2
OG0017321	1	0	0	1	2
OG0017322	1	0	0	1	2
OG0017323	1	0	0	1	2
OG0017324	1	0	0	1	2
OG0017325	1	0	0	1	2
OG0017326	1	0	0	1	2
OG0017327	1	0	0	1	2
OG0017328	1	0	1	0	2
OG0017329	1	0	0	1	2
OG0017330	1	0	0	1	2
OG0017331	1	0	0	1	2
OG0017332	1	0	0	1	2
OG0017333	2	0	0	0	2
OG0017334	1	0	0	1	2
OG0017335	1	0	0	1	2
OG0017336	1	0	0	1	2
OG0017337	1	1	0	0	2
OG0017338	1	0	0	1	2
OG0017339	1	0	0	1	2
OG0017340	1	1	0	0	2
OG0017341	1	0	0	1	2
OG0017342	1	0	0	1	2
OG0017343	1	0	0	1	2
OG0017344	1	0	0	1	2
OG0017345	1	0	0	1	2
OG0017346	1	0	0	1	2
OG0017347	1	0	0	1	2
OG0017348	2	0	0	0	2
OG0017349	1	0	0	1	2
OG0017350	2	0	0	0	2
OG0017351	2	0	0	0	2
OG0017352	1	0	0	1	2
OG0017353	1	0	0	1	2
OG0017354	1	1	0	0	2
OG0017355	1	0	0	1	2
OG0017356	1	0	0	1	2
OG0017357	1	0	0	1	2
OG0017358	2	0	0	0	2
OG0017359	1	0	0	1	2
OG0017360	1	0	0	1	2
OG0017361	1	0	0	1	2
OG0017362	2	0	0	0	2
OG0017363	1	0	0	1	2
OG0017364	1	0	0	1	2
OG0017365	1	0	0	1	2
OG0017366	1	0	0	1	2
OG0017367	1	0	0	1	2
OG0017368	2	0	0	0	2
OG0017369	1	0	0	1	2
OG0017370	2	0	0	0	2
OG0017371	2	0	0	0	2
OG0017372	1	0	0	1	2
OG0017373	1	0	0	1	2
OG0017374	2	0	0	0	2
OG0017375	2	0	0	0	2
OG0017376	1	0	0	1	2
OG0017377	2	0	0	0	2
OG0017378	1	0	0	1	2
OG0017379	2	0	0	0	2
OG0017380	1	0	0	1	2
OG0017381	1	0	0	1	2
OG0017382	1	0	0	1	2
OG0017383	1	0	0	1	2
OG0017384	2	0	0	0	2
OG0017385	1	0	0	1	2
OG0017386	1	0	0	1	2
OG0017387	1	0	0	1	2
OG0017388	1	0	0	1	2
OG0017389	1	0	0	1	2
OG0017390	1	0	0	1	2
OG0017391	1	0	0	1	2
OG0017392	2	0	0	0	2
OG0017393	1	0	0	1	2
OG0017394	2	0	0	0	2
OG0017395	2	0	0	0	2
OG0017396	1	0	0	1	2
OG0017397	1	0	0	1	2
OG0017398	1	0	0	1	2
OG0017399	1	0	0	1	2
OG0017400	2	0	0	0	2
OG0017401	1	0	0	1	2
OG0017402	1	0	0	1	2
OG0017403	1	0	0	1	2
OG0017404	2	0	0	0	2
OG0017405	1	0	0	1	2
OG0017406	2	0	0	0	2
OG0017407	1	0	0	1	2
OG0017408	1	0	0	1	2
OG0017409	1	0	0	1	2
OG0017410	1	0	0	1	2
OG0017411	1	0	0	1	2
OG0017412	1	0	0	1	2
OG0017413	1	0	0	1	2
OG0017414	2	0	0	0	2
OG0017415	1	0	0	1	2
OG0017416	1	0	0	1	2
OG0017417	1	0	0	1	2
OG0017418	2	0	0	0	2
OG0017419	1	0	0	1	2
OG0017420	1	0	0	1	2
OG0017421	1	0	0	1	2
OG0017422	1	0	0	1	2
OG0017423	1	0	0	1	2
OG0017424	1	0	0	1	2
OG0017425	1	0	0	1	2
OG0017426	1	0	0	1	2
OG0017427	1	0	0	1	2
OG0017428	1	0	0	1	2
OG0017429	1	0	0	1	2
OG0017430	1	0	0	1	2
OG0017431	2	0	0	0	2
OG0017432	1	0	0	1	2
OG0017433	1	0	0	1	2
OG0017434	1	1	0	0	2
OG0017435	1	0	0	1	2
OG0017436	1	0	0	1	2
OG0017437	1	0	0	1	2
OG0017438	1	0	0	1	2
OG0017439	1	0	0	1	2
OG0017440	2	0	0	0	2
OG0017441	1	0	0	1	2
OG0017442	1	1	0	0	2
OG0017443	1	0	0	1	2
OG0017444	2	0	0	0	2
OG0017445	1	0	0	1	2
OG0017446	1	0	0	1	2
OG0017447	1	1	0	0	2
OG0017448	1	0	0	1	2
OG0017449	1	0	0	1	2
OG0017450	1	0	0	1	2
OG0017451	1	0	0	1	2
OG0017452	1	0	0	1	2
OG0017453	1	0	0	1	2
OG0017454	1	0	0	1	2
OG0017455	1	0	0	1	2
OG0017456	1	0	0	1	2
OG0017457	1	0	0	1	2
OG0017458	1	0	0	1	2
OG0017459	1	0	0	1	2
OG0017460	1	0	0	1	2
OG0017461	1	0	0	1	2
OG0017462	1	0	0	1	2
OG0017463	1	0	0	1	2
OG0017464	1	0	0	1	2
OG0017465	1	0	0	1	2
OG0017466	1	0	0	1	2
OG0017467	1	0	0	1	2
OG0017468	1	0	0	1	2
OG0017469	1	0	0	1	2
OG0017470	1	0	0	1	2
OG0017471	1	0	0	1	2
OG0017472	1	0	0	1	2
OG0017473	1	1	0	0	2
OG0017474	1	0	0	1	2
OG0017475	1	0	0	1	2
OG0017476	1	0	0	1	2
OG0017477	1	0	0	1	2
OG0017478	2	0	0	0	2
OG0017479	2	0	0	0	2
OG0017480	1	0	0	1	2
OG0017481	2	0	0	0	2
OG0017482	1	0	0	1	2
OG0017483	1	0	0	1	2
OG0017484	1	0	0	1	2
OG0017485	1	0	0	1	2
OG0017486	1	0	0	1	2
OG0017487	1	0	0	1	2
OG0017488	1	0	0	1	2
OG0017489	1	0	0	1	2
OG0017490	1	0	0	1	2
OG0017491	1	0	0	1	2
OG0017492	1	0	0	1	2
OG0017493	1	0	0	1	2
OG0017494	1	0	1	0	2
OG0017495	1	0	0	1	2
OG0017496	1	0	0	1	2
OG0017497	1	0	0	1	2
OG0017498	2	0	0	0	2
OG0017499	1	0	0	1	2
OG0017500	1	0	0	1	2
OG0017501	1	0	0	1	2
OG0017502	1	0	0	1	2
OG0017503	1	0	0	1	2
OG0017504	1	0	0	1	2
OG0017505	1	0	0	1	2
OG0017506	1	0	0	1	2
OG0017507	1	0	0	1	2
OG0017508	1	0	0	1	2
OG0017509	2	0	0	0	2
OG0017510	1	0	0	1	2
OG0017511	1	0	0	1	2
OG0017512	1	0	0	1	2
OG0017513	1	0	0	1	2
OG0017514	1	0	0	1	2
OG0017515	2	0	0	0	2
OG0017516	2	0	0	0	2
OG0017517	2	0	0	0	2
OG0017518	2	0	0	0	2
OG0017519	2	0	0	0	2
OG0017520	1	0	0	1	2
OG0017521	1	0	0	1	2
OG0017522	1	0	0	1	2
OG0017523	1	0	0	1	2
OG0017524	1	0	0	1	2
OG0017525	1	0	0	1	2
OG0017526	1	0	0	1	2
OG0017527	1	0	0	1	2
OG0017528	1	0	0	1	2
OG0017529	1	0	0	1	2
OG0017530	1	0	0	1	2
OG0017531	1	0	0	1	2
OG0017532	1	0	0	1	2
OG0017533	1	0	0	1	2
OG0017534	1	0	0	1	2
OG0017535	1	0	0	1	2
OG0017536	1	0	0	1	2
OG0017537	1	0	0	1	2
OG0017538	1	0	0	1	2
OG0017539	1	0	0	1	2
OG0017540	1	0	0	1	2
OG0017541	1	0	0	1	2
OG0017542	1	0	0	1	2
OG0017543	1	0	0	1	2
OG0017544	1	0	0	1	2
OG0017545	2	0	0	0	2
OG0017546	1	0	0	1	2
OG0017547	2	0	0	0	2
OG0017548	1	0	0	1	2
OG0017549	1	0	0	1	2
OG0017550	1	0	0	1	2
OG0017551	1	0	0	1	2
OG0017552	2	0	0	0	2
OG0017553	1	0	0	1	2
OG0017554	1	0	0	1	2
OG0017555	1	0	0	1	2
OG0017556	2	0	0	0	2
OG0017557	1	0	0	1	2
OG0017558	1	0	0	1	2
OG0017559	1	0	0	1	2
OG0017560	1	0	0	1	2
OG0017561	1	0	0	1	2
OG0017562	1	0	0	1	2
OG0017563	1	0	0	1	2
OG0017564	1	0	0	1	2
OG0017565	1	0	0	1	2
OG0017566	1	0	0	1	2
OG0017567	2	0	0	0	2
OG0017568	1	0	0	1	2
OG0017569	1	0	0	1	2
OG0017570	1	0	0	1	2
OG0017571	2	0	0	0	2
OG0017572	1	0	0	1	2
OG0017573	1	0	0	1	2
OG0017574	1	0	0	1	2
OG0017575	1	0	0	1	2
OG0017576	1	0	0	1	2
OG0017577	1	0	0	1	2
OG0017578	1	0	0	1	2
OG0017579	1	0	0	1	2
OG0017580	2	0	0	0	2
OG0017581	1	0	0	1	2
OG0017582	1	0	0	1	2
OG0017583	2	0	0	0	2
OG0017584	1	0	0	1	2
OG0017585	1	0	0	1	2
OG0017586	1	0	0	1	2
OG0017587	1	0	0	1	2
OG0017588	1	0	0	1	2
OG0017589	1	0	0	1	2
OG0017590	1	0	0	1	2
OG0017591	1	0	0	1	2
OG0017592	1	0	0	1	2
OG0017593	1	0	0	1	2
OG0017594	1	0	0	1	2
OG0017595	1	0	0	1	2
OG0017596	1	0	0	1	2
OG0017597	1	0	0	1	2
OG0017598	1	0	0	1	2
OG0017599	1	0	0	1	2
OG0017600	2	0	0	0	2
OG0017601	2	0	0	0	2
OG0017602	1	0	0	1	2
OG0017603	2	0	0	0	2
OG0017604	1	0	0	1	2
OG0017605	2	0	0	0	2
OG0017606	2	0	0	0	2
OG0017607	1	0	0	1	2
OG0017608	1	0	0	1	2
OG0017609	1	0	1	0	2
OG0017610	1	0	0	1	2
OG0017611	1	0	0	1	2
OG0017612	1	0	0	1	2
OG0017613	1	0	0	1	2
OG0017614	1	0	0	1	2
OG0017615	2	0	0	0	2
OG0017616	1	1	0	0	2
OG0017617	1	0	0	1	2
OG0017618	1	0	0	1	2
OG0017619	1	0	0	1	2
OG0017620	1	0	0	1	2
OG0017621	1	0	0	1	2
OG0017622	1	0	0	1	2
OG0017623	1	0	0	1	2
OG0017624	1	0	0	1	2
OG0017625	1	0	0	1	2
OG0017626	1	0	0	1	2
OG0017627	1	0	0	1	2
OG0017628	1	0	0	1	2
OG0017629	1	0	0	1	2
OG0017630	1	0	0	1	2
OG0017631	1	0	0	1	2
OG0017632	1	0	0	1	2
OG0017633	1	0	0	1	2
OG0017634	1	0	0	1	2
OG0017635	1	0	0	1	2
OG0017636	1	0	0	1	2
OG0017637	1	0	0	1	2
OG0017638	1	0	0	1	2
OG0017639	1	0	0	1	2
OG0017640	1	0	0	1	2
OG0017641	1	0	0	1	2
OG0017642	1	0	0	1	2
OG0017643	1	0	0	1	2
OG0017644	1	0	0	1	2
OG0017645	1	0	0	1	2
OG0017646	1	0	0	1	2
OG0017647	1	0	1	0	2
OG0017648	1	0	0	1	2
OG0017649	1	0	0	1	2
OG0017650	1	0	0	1	2
OG0017651	1	0	0	1	2
OG0017652	1	0	0	1	2
OG0017653	1	0	0	1	2
OG0017654	1	0	0	1	2
OG0017655	1	0	0	1	2
OG0017656	1	0	0	1	2
OG0017657	1	0	0	1	2
OG0017658	1	0	0	1	2
OG0017659	1	0	0	1	2
OG0017660	1	0	0	1	2
OG0017661	1	0	0	1	2
OG0017662	1	0	0	1	2
OG0017663	1	0	0	1	2
OG0017664	1	0	0	1	2
OG0017665	1	0	0	1	2
OG0017666	1	0	0	1	2
OG0017667	1	0	0	1	2
OG0017668	1	0	0	1	2
OG0017669	1	0	0	1	2
OG0017670	1	1	0	0	2
OG0017671	1	0	0	1	2
OG0017672	1	0	0	1	2
OG0017673	1	0	0	1	2
OG0017674	1	0	0	1	2
OG0017675	1	0	0	1	2
OG0017676	2	0	0	0	2
OG0017677	1	0	0	1	2
OG0017678	1	0	0	1	2
OG0017679	1	0	0	1	2
OG0017680	1	0	0	1	2
OG0017681	1	0	0	1	2
OG0017682	1	0	0	1	2
OG0017683	1	0	0	1	2
OG0017684	1	0	0	1	2
OG0017685	1	0	0	1	2
OG0017686	1	0	0	1	2
OG0017687	2	0	0	0	2
OG0017688	1	0	0	1	2
OG0017689	2	0	0	0	2
OG0017690	1	0	0	1	2
OG0017691	1	0	0	1	2
OG0017692	1	0	0	1	2
OG0017693	1	0	0	1	2
OG0017694	1	0	0	1	2
OG0017695	1	0	0	1	2
OG0017696	1	0	0	1	2
OG0017697	1	0	0	1	2
OG0017698	1	0	0	1	2
OG0017699	1	0	0	1	2
OG0017700	1	0	0	1	2
OG0017701	1	0	0	1	2
OG0017702	1	0	0	1	2
OG0017703	1	0	0	1	2
OG0017704	1	0	0	1	2
OG0017705	1	0	0	1	2
OG0017706	1	0	0	1	2
OG0017707	2	0	0	0	2
OG0017708	2	0	0	0	2
OG0017709	1	0	0	1	2
OG0017710	2	0	0	0	2
OG0017711	1	0	0	1	2
OG0017712	1	0	0	1	2
OG0017713	1	0	0	1	2
OG0017714	1	0	0	1	2
OG0017715	1	0	0	1	2
OG0017716	1	0	0	1	2
OG0017717	1	0	0	1	2
OG0017718	1	0	0	1	2
OG0017719	1	0	0	1	2
OG0017720	1	0	0	1	2
OG0017721	1	0	0	1	2
OG0017722	2	0	0	0	2
OG0017723	2	0	0	0	2
OG0017724	1	0	0	1	2
OG0017725	1	0	0	1	2
OG0017726	1	0	0	1	2
OG0017727	1	0	0	1	2
OG0017728	1	0	0	1	2
OG0017729	1	0	0	1	2
OG0017730	1	0	0	1	2
OG0017731	2	0	0	0	2
OG0017732	1	0	0	1	2
OG0017733	1	0	0	1	2
OG0017734	1	0	0	1	2
OG0017735	1	0	0	1	2
OG0017736	1	0	0	1	2
OG0017737	1	0	0	1	2
OG0017738	2	0	0	0	2
OG0017739	1	0	0	1	2
OG0017740	1	0	0	1	2
OG0017741	1	0	0	1	2
OG0017742	1	0	0	1	2
OG0017743	1	0	0	1	2
OG0017744	1	0	0	1	2
OG0017745	1	0	0	1	2
OG0017746	1	0	0	1	2
OG0017747	1	0	0	1	2
OG0017748	2	0	0	0	2
OG0017749	1	0	0	1	2
OG0017750	1	0	0	1	2
OG0017751	1	0	0	1	2
OG0017752	1	0	0	1	2
OG0017753	1	0	0	1	2
OG0017754	1	0	0	1	2
OG0017755	2	0	0	0	2
OG0017756	1	0	0	1	2
OG0017757	2	0	0	0	2
OG0017758	1	0	0	1	2
OG0017759	1	0	0	1	2
OG0017760	1	0	0	1	2
OG0017761	1	0	0	1	2
OG0017762	1	0	0	1	2
OG0017763	1	0	0	1	2
OG0017764	2	0	0	0	2
OG0017765	1	0	0	1	2
OG0017766	1	0	0	1	2
OG0017767	1	0	0	1	2
OG0017768	1	0	0	1	2
OG0017769	1	0	0	1	2
OG0017770	1	0	0	1	2
OG0017771	1	0	0	1	2
OG0017772	1	0	0	1	2
OG0017773	1	0	0	1	2
OG0017774	1	0	0	1	2
OG0017775	1	0	0	1	2
OG0017776	1	0	0	1	2
OG0017777	1	0	0	1	2
OG0017778	1	0	0	1	2
OG0017779	1	0	0	1	2
OG0017780	1	0	0	1	2
OG0017781	1	0	0	1	2
OG0017782	2	0	0	0	2
OG0017783	1	0	0	1	2
OG0017784	1	0	0	1	2
OG0017785	1	0	0	1	2
OG0017786	2	0	0	0	2
OG0017787	1	0	0	1	2
OG0017788	1	0	0	1	2
OG0017789	1	0	0	1	2
OG0017790	1	0	0	1	2
OG0017791	1	0	0	1	2
OG0017792	1	0	0	1	2
OG0017793	1	0	0	1	2
OG0017794	1	0	0	1	2
OG0017795	1	1	0	0	2
OG0017796	2	0	0	0	2
OG0017797	1	0	0	1	2
OG0017798	1	0	0	1	2
OG0017799	1	0	0	1	2
OG0017800	1	0	0	1	2
OG0017801	1	0	0	1	2
OG0017802	2	0	0	0	2
OG0017803	1	0	0	1	2
OG0017804	1	0	0	1	2
OG0017805	1	0	0	1	2
OG0017806	2	0	0	0	2
OG0017807	2	0	0	0	2
OG0017808	1	1	0	0	2
OG0017809	1	0	0	1	2
OG0017810	1	0	0	1	2
OG0017811	1	0	0	1	2
OG0017812	1	0	0	1	2
OG0017813	1	0	0	1	2
OG0017814	1	0	0	1	2
OG0017815	1	0	0	1	2
OG0017816	1	0	0	1	2
OG0017817	1	0	0	1	2
OG0017818	1	0	0	1	2
OG0017819	1	0	0	1	2
OG0017820	1	0	0	1	2
OG0017821	1	0	1	0	2
OG0017822	1	0	0	1	2
OG0017823	1	0	0	1	2
OG0017824	1	0	0	1	2
OG0017825	1	0	0	1	2
OG0017826	1	0	0	1	2
OG0017827	1	0	0	1	2
OG0017828	1	0	0	1	2
OG0017829	1	0	0	1	2
OG0017830	1	0	0	1	2
OG0017831	1	0	0	1	2
OG0017832	1	0	0	1	2
OG0017833	2	0	0	0	2
OG0017834	1	0	0	1	2
OG0017835	1	0	0	1	2
OG0017836	1	1	0	0	2
OG0017837	1	0	0	1	2
OG0017838	1	0	0	1	2
OG0017839	1	0	0	1	2
OG0017840	2	0	0	0	2
OG0017841	1	0	0	1	2
OG0017842	1	0	0	1	2
OG0017843	1	0	0	1	2
OG0017844	2	0	0	0	2
OG0017845	1	0	0	1	2
OG0017846	1	0	0	1	2
OG0017847	1	0	0	1	2
OG0017848	1	0	0	1	2
OG0017849	1	0	0	1	2
OG0017850	1	0	0	1	2
OG0017851	1	0	0	1	2
OG0017852	1	0	0	1	2
OG0017853	1	0	0	1	2
OG0017854	1	0	0	1	2
OG0017855	1	0	0	1	2
OG0017856	1	0	0	1	2
OG0017857	2	0	0	0	2
OG0017858	1	0	0	1	2
OG0017859	1	0	0	1	2
OG0017860	1	0	0	1	2
OG0017861	1	0	0	1	2
OG0017862	1	0	0	1	2
OG0017863	2	0	0	0	2
OG0017864	1	0	0	1	2
OG0017865	2	0	0	0	2
OG0017866	1	0	0	1	2
OG0017867	1	0	0	1	2
OG0017868	1	0	0	1	2
OG0017869	1	0	1	0	2
OG0017870	1	0	0	1	2
OG0017871	1	0	0	1	2
OG0017872	1	0	0	1	2
OG0017873	1	0	0	1	2
OG0017874	1	0	0	1	2
OG0017875	1	0	0	1	2
OG0017876	2	0	0	0	2
OG0017877	1	0	0	1	2
OG0017878	1	0	0	1	2
OG0017879	1	0	0	1	2
OG0017880	2	0	0	0	2
OG0017881	1	0	0	1	2
OG0017882	1	0	0	1	2
OG0017883	1	0	0	1	2
OG0017884	1	0	0	1	2
OG0017885	1	0	0	1	2
OG0017886	1	0	0	1	2
OG0017887	1	0	0	1	2
OG0017888	1	0	0	1	2
OG0017889	1	0	0	1	2
OG0017890	1	0	0	1	2
OG0017891	1	0	0	1	2
OG0017892	1	0	0	1	2
OG0017893	1	0	0	1	2
OG0017894	1	0	0	1	2
OG0017895	1	0	0	1	2
OG0017896	1	0	0	1	2
OG0017897	1	0	0	1	2
OG0017898	1	0	0	1	2
OG0017899	1	0	0	1	2
OG0017900	1	0	0	1	2
OG0017901	1	0	0	1	2
OG0017902	1	0	0	1	2
OG0017903	1	0	0	1	2
OG0017904	2	0	0	0	2
OG0017905	2	0	0	0	2
OG0017906	1	0	0	1	2
OG0017907	1	0	0	1	2
OG0017908	1	0	0	1	2
OG0017909	1	0	0	1	2
OG0017910	1	0	0	1	2
OG0017911	1	0	0	1	2
OG0017912	1	0	0	1	2
OG0017913	1	0	0	1	2
OG0017914	1	0	0	1	2
OG0017915	1	0	0	1	2
OG0017916	1	0	0	1	2
OG0017917	1	0	0	1	2
OG0017918	1	0	0	1	2
OG0017919	1	0	0	1	2
OG0017920	1	0	0	1	2
OG0017921	1	0	0	1	2
OG0017922	1	0	0	1	2
OG0017923	1	0	0	1	2
OG0017924	1	0	0	1	2
OG0017925	1	0	0	1	2
OG0017926	1	0	0	1	2
OG0017927	1	0	0	1	2
OG0017928	1	0	0	1	2
OG0017929	1	1	0	0	2
OG0017930	1	0	0	1	2
OG0017931	2	0	0	0	2
OG0017932	1	0	0	1	2
OG0017933	1	0	0	1	2
OG0017934	1	0	0	1	2
OG0017935	1	0	0	1	2
OG0017936	1	0	0	1	2
OG0017937	1	0	0	1	2
OG0017938	1	0	0	1	2
OG0017939	1	0	0	1	2
OG0017940	2	0	0	0	2
OG0017941	1	0	0	1	2
OG0017942	1	1	0	0	2
OG0017943	1	0	0	1	2
OG0017944	1	0	0	1	2
OG0017945	1	0	0	1	2
OG0017946	1	0	0	1	2
OG0017947	1	0	0	1	2
OG0017948	1	0	0	1	2
OG0017949	1	0	0	1	2
OG0017950	1	0	0	1	2
OG0017951	1	0	0	1	2
OG0017952	1	0	0	1	2
OG0017953	1	0	0	1	2
OG0017954	1	0	0	1	2
OG0017955	1	0	0	1	2
OG0017956	1	0	0	1	2
OG0017957	1	0	0	1	2
OG0017958	1	0	0	1	2
OG0017959	1	0	0	1	2
OG0017960	1	0	0	1	2
OG0017961	1	0	0	1	2
OG0017962	1	0	0	1	2
OG0017963	1	0	0	1	2
OG0017964	1	0	0	1	2
OG0017965	1	0	0	1	2
OG0017966	1	0	0	1	2
OG0017967	1	0	0	1	2
OG0017968	1	1	0	0	2
OG0017969	1	0	0	1	2
OG0017970	1	1	0	0	2
OG0017971	1	0	0	1	2
OG0017972	1	0	0	1	2
OG0017973	1	0	0	1	2
OG0017974	1	0	0	1	2
OG0017975	1	0	0	1	2
OG0017976	1	0	0	1	2
OG0017977	1	0	0	1	2
OG0017978	1	0	0	1	2
OG0017979	1	0	0	1	2
OG0017980	1	0	0	1	2
OG0017981	1	0	0	1	2
OG0017982	1	0	0	1	2
OG0017983	1	0	0	1	2
OG0017984	1	0	0	1	2
OG0017985	1	0	0	1	2
OG0017986	1	0	0	1	2
OG0017987	1	0	0	1	2
OG0017988	1	0	0	1	2
OG0017989	1	0	0	1	2
OG0017990	1	0	0	1	2
OG0017991	1	0	0	1	2
OG0017992	1	0	0	1	2
OG0017993	1	0	0	1	2
OG0017994	1	0	0	1	2
OG0017995	1	0	0	1	2
OG0017996	1	0	0	1	2
OG0017997	1	0	0	1	2
OG0017998	1	0	0	1	2
OG0017999	1	0	0	1	2
OG0018000	1	0	0	1	2
OG0018001	1	0	0	1	2
OG0018002	1	0	0	1	2
OG0018003	1	0	0	1	2
OG0018004	1	0	0	1	2
OG0018005	1	0	0	1	2
OG0018006	1	0	0	1	2
OG0018007	1	0	0	1	2
OG0018008	1	0	0	1	2
OG0018009	1	0	0	1	2
OG0018010	1	0	0	1	2
OG0018011	1	0	0	1	2
OG0018012	1	0	0	1	2
OG0018013	1	0	0	1	2
OG0018014	1	0	0	1	2
OG0018015	1	0	0	1	2
OG0018016	1	0	0	1	2
OG0018017	1	0	0	1	2
OG0018018	1	0	0	1	2
OG0018019	1	0	0	1	2
OG0018020	1	0	0	1	2
OG0018021	1	0	0	1	2
OG0018022	1	0	0	1	2
OG0018023	1	0	0	1	2
OG0018024	1	0	0	1	2
OG0018025	1	0	0	1	2
OG0018026	1	0	0	1	2
OG0018027	1	0	0	1	2
OG0018028	1	0	0	1	2
OG0018029	1	0	0	1	2
OG0018030	1	0	0	1	2
OG0018031	1	0	0	1	2
OG0018032	1	0	0	1	2
OG0018033	1	0	0	1	2
OG0018034	2	0	0	0	2
OG0018035	1	0	0	1	2
OG0018036	1	0	0	1	2
OG0018037	1	0	0	1	2
OG0018038	2	0	0	0	2
OG0018039	2	0	0	0	2
OG0018040	1	0	0	1	2
OG0018041	1	0	0	1	2
OG0018042	1	0	0	1	2
OG0018043	1	0	0	1	2
OG0018044	1	1	0	0	2
OG0018045	1	0	0	1	2
OG0018046	1	0	0	1	2
OG0018047	2	0	0	0	2
OG0018048	1	0	0	1	2
OG0018049	1	0	0	1	2
OG0018050	1	0	0	1	2
OG0018051	1	0	0	1	2
OG0018052	1	0	0	1	2
OG0018053	2	0	0	0	2
OG0018054	1	0	0	1	2
OG0018055	1	0	0	1	2
OG0018056	1	0	0	1	2
OG0018057	1	0	0	1	2
OG0018058	1	0	0	1	2
OG0018059	1	0	0	1	2
OG0018060	1	0	0	1	2
OG0018061	1	0	0	1	2
OG0018062	1	0	0	1	2
OG0018063	1	0	0	1	2
OG0018064	1	0	0	1	2
OG0018065	1	0	0	1	2
OG0018066	1	0	0	1	2
OG0018067	1	0	0	1	2
OG0018068	1	0	0	1	2
OG0018069	1	0	0	1	2
OG0018070	1	0	0	1	2
OG0018071	1	0	0	1	2
OG0018072	1	0	0	1	2
OG0018073	1	0	0	1	2
OG0018074	1	0	0	1	2
OG0018075	1	0	0	1	2
OG0018076	1	0	0	1	2
OG0018077	1	0	0	1	2
OG0018078	1	0	0	1	2
OG0018079	1	0	0	1	2
OG0018080	1	1	0	0	2
OG0018081	1	0	0	1	2
OG0018082	1	0	0	1	2
OG0018083	1	0	0	1	2
OG0018084	1	0	0	1	2
OG0018085	1	0	0	1	2
OG0018086	1	0	0	1	2
OG0018087	1	0	0	1	2
OG0018088	1	0	0	1	2
OG0018089	1	0	0	1	2
OG0018090	1	0	0	1	2
OG0018091	1	0	0	1	2
OG0018092	1	0	0	1	2
OG0018093	1	0	0	1	2
OG0018094	1	0	0	1	2
OG0018095	1	0	0	1	2
OG0018096	1	0	0	1	2
OG0018097	1	0	0	1	2
OG0018098	1	0	0	1	2
OG0018099	1	0	0	1	2
OG0018100	1	0	0	1	2
OG0018101	1	0	0	1	2
OG0018102	2	0	0	0	2
OG0018103	1	1	0	0	2
OG0018104	1	0	0	1	2
OG0018105	1	0	0	1	2
OG0018106	1	0	0	1	2
OG0018107	1	1	0	0	2
OG0018108	1	0	0	1	2
OG0018109	2	0	0	0	2
OG0018110	1	0	0	1	2
OG0018111	1	0	0	1	2
OG0018112	1	0	0	1	2
OG0018113	1	0	0	1	2
OG0018114	1	0	0	1	2
OG0018115	1	0	0	1	2
OG0018116	1	0	0	1	2
OG0018117	1	0	0	1	2
OG0018118	1	0	0	1	2
OG0018119	1	0	0	1	2
OG0018120	1	0	0	1	2
OG0018121	1	0	0	1	2
OG0018122	1	1	0	0	2
OG0018123	1	0	0	1	2
OG0018124	1	0	0	1	2
OG0018125	1	0	0	1	2
OG0018126	2	0	0	0	2
OG0018127	1	0	0	1	2
OG0018128	1	0	0	1	2
OG0018129	1	0	0	1	2
OG0018130	1	0	0	1	2
OG0018131	1	0	0	1	2
OG0018132	1	0	0	1	2
OG0018133	1	1	0	0	2
OG0018134	1	0	0	1	2
OG0018135	1	0	0	1	2
OG0018136	1	0	0	1	2
OG0018137	1	0	0	1	2
OG0018138	1	0	0	1	2
OG0018139	1	0	0	1	2
OG0018140	1	0	0	1	2
OG0018141	1	0	0	1	2
OG0018142	1	0	0	1	2
OG0018143	1	0	0	1	2
OG0018144	1	0	0	1	2
OG0018145	1	0	0	1	2
OG0018146	1	0	0	1	2
OG0018147	1	0	0	1	2
OG0018148	1	0	0	1	2
OG0018149	1	0	0	1	2
OG0018150	1	0	0	1	2
OG0018151	1	0	0	1	2
OG0018152	1	0	0	1	2
OG0018153	2	0	0	0	2
OG0018154	1	0	0	1	2
OG0018155	1	0	0	1	2
OG0018156	1	0	0	1	2
OG0018157	1	0	0	1	2
OG0018158	1	1	0	0	2
OG0018159	1	0	1	0	2
OG0018160	1	0	0	1	2
OG0018161	1	0	0	1	2
OG0018162	1	0	0	1	2
OG0018163	1	0	0	1	2
OG0018164	1	0	0	1	2
OG0018165	1	0	0	1	2
OG0018166	1	1	0	0	2
OG0018167	1	0	0	1	2
OG0018168	1	0	0	1	2
OG0018169	1	0	0	1	2
OG0018170	2	0	0	0	2
OG0018171	2	0	0	0	2
OG0018172	2	0	0	0	2
OG0018173	1	0	0	1	2
OG0018174	2	0	0	0	2
OG0018175	1	0	0	1	2
OG0018176	2	0	0	0	2
OG0018177	1	0	0	1	2
OG0018178	1	0	0	1	2
OG0018179	1	1	0	0	2
OG0018180	1	0	0	1	2
OG0018181	1	0	0	1	2
OG0018182	1	0	0	1	2
OG0018183	1	0	0	1	2
OG0018184	2	0	0	0	2
OG0018185	1	0	0	1	2
OG0018186	1	0	0	1	2
OG0018187	1	0	0	1	2
OG0018188	1	0	0	1	2
OG0018189	1	0	0	1	2
OG0018190	1	0	0	1	2
OG0018191	1	0	0	1	2
OG0018192	1	0	0	1	2
OG0018193	1	0	0	1	2
OG0018194	1	1	0	0	2
OG0018195	1	0	0	1	2
OG0018196	1	0	0	1	2
OG0018197	1	0	0	1	2
OG0018198	1	0	0	1	2
OG0018199	1	0	0	1	2
OG0018200	1	0	0	1	2
OG0018201	1	0	0	1	2
OG0018202	1	0	0	1	2
OG0018203	1	0	0	1	2
OG0018204	2	0	0	0	2
OG0018205	1	0	0	1	2
OG0018206	1	0	0	1	2
OG0018207	2	0	0	0	2
OG0018208	1	0	0	1	2
OG0018209	1	0	0	1	2
OG0018210	1	0	0	1	2
OG0018211	1	0	0	1	2
OG0018212	1	0	0	1	2
OG0018213	1	0	0	1	2
OG0018214	1	0	0	1	2
OG0018215	1	0	0	1	2
OG0018216	1	0	0	1	2
OG0018217	1	0	0	1	2
OG0018218	1	0	0	1	2
OG0018219	1	0	0	1	2
OG0018220	1	0	0	1	2
OG0018221	1	0	0	1	2
OG0018222	1	0	0	1	2
OG0018223	1	0	0	1	2
OG0018224	1	0	0	1	2
OG0018225	1	0	0	1	2
OG0018226	1	0	0	1	2
OG0018227	1	0	0	1	2
OG0018228	1	0	0	1	2
OG0018229	1	0	0	1	2
OG0018230	1	0	0	1	2
OG0018231	1	0	0	1	2
OG0018232	1	0	0	1	2
OG0018233	1	0	0	1	2
OG0018234	1	1	0	0	2
OG0018235	1	0	0	1	2
OG0018236	1	0	0	1	2
OG0018237	2	0	0	0	2
OG0018238	1	0	0	1	2
OG0018239	1	0	0	1	2
OG0018240	1	0	0	1	2
OG0018241	1	0	0	1	2
OG0018242	1	0	0	1	2
OG0018243	1	0	0	1	2
OG0018244	1	0	0	1	2
OG0018245	1	0	0	1	2
OG0018246	1	0	0	1	2
OG0018247	1	0	0	1	2
OG0018248	1	0	0	1	2
OG0018249	1	0	0	1	2
OG0018250	1	0	0	1	2
OG0018251	1	0	0	1	2
OG0018252	1	0	0	1	2
OG0018253	1	0	0	1	2
OG0018254	1	0	0	1	2
OG0018255	1	0	0	1	2
OG0018256	1	0	0	1	2
OG0018257	1	0	0	1	2
OG0018258	1	0	0	1	2
OG0018259	1	0	0	1	2
OG0018260	1	0	0	1	2
OG0018261	1	0	0	1	2
OG0018262	1	0	0	1	2
OG0018263	1	0	0	1	2
OG0018264	1	0	0	1	2
OG0018265	1	0	0	1	2
OG0018266	1	0	0	1	2
OG0018267	1	0	0	1	2
OG0018268	1	0	0	1	2
OG0018269	1	0	0	1	2
OG0018270	1	0	0	1	2
OG0018271	1	0	0	1	2
OG0018272	1	0	0	1	2
OG0018273	1	0	0	1	2
OG0018274	1	0	0	1	2
OG0018275	1	0	0	1	2
OG0018276	1	0	0	1	2
OG0018277	1	0	0	1	2
OG0018278	1	0	0	1	2
OG0018279	1	0	0	1	2
OG0018280	1	0	0	1	2
OG0018281	1	0	0	1	2
OG0018282	2	0	0	0	2
OG0018283	1	0	0	1	2
OG0018284	1	0	0	1	2
OG0018285	1	0	0	1	2
OG0018286	1	0	0	1	2
OG0018287	1	0	0	1	2
OG0018288	1	0	0	1	2
OG0018289	1	0	0	1	2
OG0018290	1	0	0	1	2
OG0018291	1	0	0	1	2
OG0018292	1	0	0	1	2
OG0018293	1	0	0	1	2
OG0018294	1	0	0	1	2
OG0018295	1	0	0	1	2
OG0018296	1	0	0	1	2
OG0018297	1	0	0	1	2
OG0018298	1	0	0	1	2
OG0018299	1	0	0	1	2
OG0018300	1	0	0	1	2
OG0018301	1	0	0	1	2
OG0018302	1	0	0	1	2
OG0018303	1	0	0	1	2
OG0018304	1	0	0	1	2
OG0018305	2	0	0	0	2
OG0018306	1	0	0	1	2
OG0018307	1	0	0	1	2
OG0018308	1	0	0	1	2
OG0018309	1	0	0	1	2
OG0018310	1	0	0	1	2
OG0018311	1	0	0	1	2
OG0018312	1	0	0	1	2
OG0018313	1	0	0	1	2
OG0018314	1	0	0	1	2
OG0018315	1	0	0	1	2
OG0018316	1	0	0	1	2
OG0018317	1	0	0	1	2
OG0018318	2	0	0	0	2
OG0018319	2	0	0	0	2
OG0018320	1	0	0	1	2
OG0018321	1	0	0	1	2
OG0018322	1	0	0	1	2
OG0018323	1	0	0	1	2
OG0018324	1	0	0	1	2
OG0018325	1	0	0	1	2
OG0018326	1	0	0	1	2
OG0018327	1	0	0	1	2
OG0018328	1	0	0	1	2
OG0018329	1	0	0	1	2
OG0018330	1	0	0	1	2
OG0018331	1	0	0	1	2
OG0018332	1	0	0	1	2
OG0018333	1	1	0	0	2
OG0018334	1	0	0	1	2
OG0018335	1	1	0	0	2
OG0018336	1	0	0	1	2
OG0018337	1	0	0	1	2
OG0018338	1	0	0	1	2
OG0018339	1	0	0	1	2
OG0018340	1	1	0	0	2
OG0018341	1	1	0	0	2
OG0018342	1	0	0	1	2
OG0018343	1	0	1	0	2
OG0018344	2	0	0	0	2
OG0018345	1	0	0	1	2
OG0018346	1	0	1	0	2
OG0018347	1	0	0	1	2
OG0018348	1	0	0	1	2
OG0018349	0	2	0	0	2
OG0018350	0	2	0	0	2
OG0018351	0	2	0	0	2
OG0018352	0	2	0	0	2
OG0018353	0	2	0	0	2
OG0018354	0	2	0	0	2
OG0018355	0	2	0	0	2
OG0018356	0	2	0	0	2
OG0018357	0	2	0	0	2
OG0018358	0	1	1	0	2
OG0018359	0	2	0	0	2
OG0018360	0	2	0	0	2
OG0018361	0	2	0	0	2
OG0018362	0	2	0	0	2
OG0018363	0	2	0	0	2
OG0018364	0	2	0	0	2
OG0018365	0	1	1	0	2
OG0018366	0	2	0	0	2
OG0018367	0	2	0	0	2
OG0018368	0	2	0	0	2
OG0018369	0	2	0	0	2
OG0018370	0	2	0	0	2
OG0018371	0	2	0	0	2
OG0018372	0	2	0	0	2
OG0018373	0	2	0	0	2
OG0018374	0	2	0	0	2
OG0018375	0	2	0	0	2
OG0018376	0	2	0	0	2
OG0018377	0	2	0	0	2
OG0018378	0	2	0	0	2
OG0018379	0	1	1	0	2
OG0018380	0	2	0	0	2
OG0018381	0	2	0	0	2
OG0018382	0	2	0	0	2
OG0018383	0	1	1	0	2
OG0018384	0	2	0	0	2
OG0018385	0	2	0	0	2
OG0018386	0	2	0	0	2
OG0018387	0	2	0	0	2
OG0018388	0	2	0	0	2
OG0018389	0	2	0	0	2
OG0018390	0	2	0	0	2
OG0018391	0	2	0	0	2
OG0018392	0	2	0	0	2
OG0018393	0	2	0	0	2
OG0018394	0	2	0	0	2
OG0018395	0	2	0	0	2
OG0018396	0	2	0	0	2
OG0018397	0	2	0	0	2
OG0018398	0	2	0	0	2
OG0018399	0	2	0	0	2
OG0018400	0	2	0	0	2
OG0018401	0	2	0	0	2
OG0018402	0	2	0	0	2
OG0018403	0	2	0	0	2
OG0018404	0	2	0	0	2
OG0018405	0	2	0	0	2
OG0018406	0	1	1	0	2
OG0018407	0	2	0	0	2
OG0018408	0	2	0	0	2
OG0018409	0	2	0	0	2
OG0018410	0	1	0	1	2
OG0018411	0	2	0	0	2
OG0018412	0	2	0	0	2
OG0018413	0	2	0	0	2
OG0018414	0	2	0	0	2
OG0018415	0	2	0	0	2
OG0018416	0	2	0	0	2
OG0018417	0	2	0	0	2
OG0018418	0	2	0	0	2
OG0018419	0	2	0	0	2
OG0018420	0	2	0	0	2
OG0018421	0	2	0	0	2
OG0018422	0	2	0	0	2
OG0018423	0	2	0	0	2
OG0018424	0	2	0	0	2
OG0018425	0	2	0	0	2
OG0018426	0	2	0	0	2
OG0018427	0	2	0	0	2
OG0018428	0	2	0	0	2
OG0018429	0	2	0	0	2
OG0018430	0	2	0	0	2
OG0018431	0	2	0	0	2
OG0018432	0	2	0	0	2
OG0018433	0	2	0	0	2
OG0018434	0	2	0	0	2
OG0018435	0	2	0	0	2
OG0018436	0	2	0	0	2
OG0018437	0	2	0	0	2
OG0018438	0	2	0	0	2
OG0018439	0	2	0	0	2
OG0018440	0	2	0	0	2
OG0018441	0	2	0	0	2
OG0018442	0	2	0	0	2
OG0018443	0	2	0	0	2
OG0018444	0	2	0	0	2
OG0018445	0	2	0	0	2
OG0018446	0	2	0	0	2
OG0018447	0	2	0	0	2
OG0018448	0	2	0	0	2
OG0018449	0	2	0	0	2
OG0018450	0	2	0	0	2
OG0018451	0	2	0	0	2
OG0018452	0	2	0	0	2
OG0018453	0	2	0	0	2
OG0018454	0	2	0	0	2
OG0018455	0	2	0	0	2
OG0018456	0	2	0	0	2
OG0018457	0	2	0	0	2
OG0018458	0	2	0	0	2
OG0018459	0	2	0	0	2
OG0018460	0	2	0	0	2
OG0018461	0	2	0	0	2
OG0018462	0	2	0	0	2
OG0018463	0	2	0	0	2
OG0018464	0	2	0	0	2
OG0018465	0	2	0	0	2
OG0018466	0	2	0	0	2
OG0018467	0	2	0	0	2
OG0018468	0	2	0	0	2
OG0018469	0	2	0	0	2
OG0018470	0	2	0	0	2
OG0018471	0	2	0	0	2
OG0018472	0	2	0	0	2
OG0018473	0	2	0	0	2
OG0018474	0	2	0	0	2
OG0018475	0	2	0	0	2
OG0018476	0	2	0	0	2
OG0018477	0	2	0	0	2
OG0018478	0	2	0	0	2
OG0018479	0	2	0	0	2
OG0018480	0	2	0	0	2
OG0018481	0	2	0	0	2
OG0018482	0	1	0	1	2
OG0018483	0	2	0	0	2
OG0018484	0	2	0	0	2
OG0018485	0	2	0	0	2
OG0018486	0	2	0	0	2
OG0018487	0	2	0	0	2
OG0018488	0	2	0	0	2
OG0018489	0	2	0	0	2
OG0018490	0	2	0	0	2
OG0018491	0	2	0	0	2
OG0018492	0	2	0	0	2
OG0018493	0	2	0	0	2
OG0018494	0	2	0	0	2
OG0018495	0	2	0	0	2
OG0018496	0	2	0	0	2
OG0018497	0	2	0	0	2
OG0018498	0	2	0	0	2
OG0018499	0	2	0	0	2
OG0018500	0	2	0	0	2
OG0018501	0	2	0	0	2
OG0018502	0	2	0	0	2
OG0018503	0	2	0	0	2
OG0018504	0	2	0	0	2
OG0018505	0	2	0	0	2
OG0018506	0	2	0	0	2
OG0018507	0	2	0	0	2
OG0018508	0	2	0	0	2
OG0018509	0	2	0	0	2
OG0018510	0	2	0	0	2
OG0018511	0	2	0	0	2
OG0018512	0	2	0	0	2
OG0018513	0	2	0	0	2
OG0018514	0	2	0	0	2
OG0018515	0	2	0	0	2
OG0018516	0	2	0	0	2
OG0018517	0	2	0	0	2
OG0018518	0	2	0	0	2
OG0018519	0	1	1	0	2
OG0018520	0	2	0	0	2
OG0018521	0	2	0	0	2
OG0018522	0	2	0	0	2
OG0018523	0	2	0	0	2
OG0018524	0	2	0	0	2
OG0018525	0	2	0	0	2
OG0018526	0	2	0	0	2
OG0018527	0	2	0	0	2
OG0018528	0	2	0	0	2
OG0018529	0	2	0	0	2
OG0018530	0	2	0	0	2
OG0018531	0	2	0	0	2
OG0018532	0	2	0	0	2
OG0018533	0	2	0	0	2
OG0018534	0	2	0	0	2
OG0018535	0	2	0	0	2
OG0018536	0	2	0	0	2
OG0018537	0	2	0	0	2
OG0018538	0	2	0	0	2
OG0018539	0	2	0	0	2
OG0018540	0	2	0	0	2
OG0018541	0	2	0	0	2
OG0018542	0	2	0	0	2
OG0018543	0	2	0	0	2
OG0018544	0	2	0	0	2
OG0018545	0	2	0	0	2
OG0018546	0	2	0	0	2
OG0018547	0	2	0	0	2
OG0018548	0	2	0	0	2
OG0018549	0	2	0	0	2
OG0018550	0	2	0	0	2
OG0018551	0	2	0	0	2
OG0018552	0	2	0	0	2
OG0018553	0	2	0	0	2
OG0018554	0	2	0	0	2
OG0018555	0	2	0	0	2
OG0018556	0	2	0	0	2
OG0018557	0	2	0	0	2
OG0018558	0	2	0	0	2
OG0018559	0	1	0	1	2
OG0018560	0	2	0	0	2
OG0018561	0	2	0	0	2
OG0018562	0	2	0	0	2
OG0018563	0	2	0	0	2
OG0018564	0	2	0	0	2
OG0018565	0	2	0	0	2
OG0018566	0	2	0	0	2
OG0018567	0	2	0	0	2
OG0018568	0	2	0	0	2
OG0018569	0	2	0	0	2
OG0018570	0	2	0	0	2
OG0018571	0	2	0	0	2
OG0018572	0	2	0	0	2
OG0018573	0	2	0	0	2
OG0018574	0	2	0	0	2
OG0018575	0	2	0	0	2
OG0018576	0	2	0	0	2
OG0018577	0	2	0	0	2
OG0018578	0	2	0	0	2
OG0018579	0	2	0	0	2
OG0018580	0	2	0	0	2
OG0018581	0	2	0	0	2
OG0018582	0	2	0	0	2
OG0018583	0	2	0	0	2
OG0018584	0	2	0	0	2
OG0018585	0	2	0	0	2
OG0018586	0	2	0	0	2
OG0018587	0	2	0	0	2
OG0018588	0	2	0	0	2
OG0018589	0	2	0	0	2
OG0018590	0	2	0	0	2
OG0018591	0	2	0	0	2
OG0018592	0	2	0	0	2
OG0018593	0	2	0	0	2
OG0018594	0	2	0	0	2
OG0018595	0	2	0	0	2
OG0018596	0	2	0	0	2
OG0018597	0	2	0	0	2
OG0018598	0	2	0	0	2
OG0018599	0	1	1	0	2
OG0018600	0	2	0	0	2
OG0018601	0	1	0	1	2
OG0018602	0	2	0	0	2
OG0018603	0	2	0	0	2
OG0018604	0	2	0	0	2
OG0018605	0	2	0	0	2
OG0018606	0	2	0	0	2
OG0018607	0	2	0	0	2
OG0018608	0	2	0	0	2
OG0018609	0	2	0	0	2
OG0018610	0	2	0	0	2
OG0018611	0	2	0	0	2
OG0018612	0	2	0	0	2
OG0018613	0	2	0	0	2
OG0018614	0	2	0	0	2
OG0018615	0	2	0	0	2
OG0018616	0	2	0	0	2
OG0018617	0	2	0	0	2
OG0018618	0	2	0	0	2
OG0018619	0	2	0	0	2
OG0018620	0	2	0	0	2
OG0018621	0	2	0	0	2
OG0018622	0	2	0	0	2
OG0018623	0	2	0	0	2
OG0018624	0	2	0	0	2
OG0018625	0	2	0	0	2
OG0018626	0	2	0	0	2
OG0018627	0	2	0	0	2
OG0018628	0	2	0	0	2
OG0018629	0	2	0	0	2
OG0018630	0	2	0	0	2
OG0018631	0	2	0	0	2
OG0018632	0	2	0	0	2
OG0018633	0	2	0	0	2
OG0018634	0	2	0	0	2
OG0018635	0	2	0	0	2
OG0018636	0	2	0	0	2
OG0018637	0	2	0	0	2
OG0018638	0	2	0	0	2
OG0018639	0	2	0	0	2
OG0018640	0	2	0	0	2
OG0018641	0	2	0	0	2
OG0018642	0	2	0	0	2
OG0018643	0	2	0	0	2
OG0018644	0	2	0	0	2
OG0018645	0	2	0	0	2
OG0018646	0	2	0	0	2
OG0018647	0	2	0	0	2
OG0018648	0	2	0	0	2
OG0018649	0	2	0	0	2
OG0018650	0	2	0	0	2
OG0018651	0	2	0	0	2
OG0018652	0	2	0	0	2
OG0018653	0	2	0	0	2
OG0018654	0	2	0	0	2
OG0018655	0	2	0	0	2
OG0018656	0	2	0	0	2
OG0018657	0	2	0	0	2
OG0018658	0	2	0	0	2
OG0018659	0	2	0	0	2
OG0018660	0	2	0	0	2
OG0018661	0	2	0	0	2
OG0018662	0	2	0	0	2
OG0018663	0	2	0	0	2
OG0018664	0	2	0	0	2
OG0018665	0	2	0	0	2
OG0018666	0	2	0	0	2
OG0018667	0	2	0	0	2
OG0018668	0	2	0	0	2
OG0018669	0	2	0	0	2
OG0018670	0	2	0	0	2
OG0018671	0	2	0	0	2
OG0018672	0	2	0	0	2
OG0018673	0	2	0	0	2
OG0018674	0	2	0	0	2
OG0018675	0	2	0	0	2
OG0018676	0	2	0	0	2
OG0018677	0	2	0	0	2
OG0018678	0	2	0	0	2
OG0018679	0	2	0	0	2
OG0018680	0	2	0	0	2
OG0018681	0	2	0	0	2
OG0018682	0	2	0	0	2
OG0018683	0	2	0	0	2
OG0018684	0	2	0	0	2
OG0018685	0	2	0	0	2
OG0018686	0	1	1	0	2
OG0018687	0	1	0	1	2
OG0018688	0	2	0	0	2
OG0018689	0	2	0	0	2
OG0018690	0	2	0	0	2
OG0018691	0	1	1	0	2
OG0018692	0	1	1	0	2
OG0018693	0	2	0	0	2
OG0018694	0	2	0	0	2
OG0018695	0	2	0	0	2
OG0018696	0	2	0	0	2
OG0018697	0	2	0	0	2
OG0018698	0	2	0	0	2
OG0018699	0	2	0	0	2
OG0018700	0	2	0	0	2
OG0018701	0	2	0	0	2
OG0018702	0	2	0	0	2
OG0018703	0	2	0	0	2
OG0018704	0	2	0	0	2
OG0018705	0	2	0	0	2
OG0018706	0	2	0	0	2
OG0018707	0	2	0	0	2
OG0018708	0	2	0	0	2
OG0018709	0	2	0	0	2
OG0018710	0	2	0	0	2
OG0018711	0	2	0	0	2
OG0018712	0	2	0	0	2
OG0018713	0	2	0	0	2
OG0018714	0	2	0	0	2
OG0018715	0	2	0	0	2
OG0018716	0	2	0	0	2
OG0018717	0	2	0	0	2
OG0018718	0	2	0	0	2
OG0018719	0	2	0	0	2
OG0018720	0	2	0	0	2
OG0018721	0	1	1	0	2
OG0018722	0	2	0	0	2
OG0018723	0	2	0	0	2
OG0018724	0	2	0	0	2
OG0018725	0	2	0	0	2
OG0018726	0	2	0	0	2
OG0018727	0	2	0	0	2
OG0018728	0	2	0	0	2
OG0018729	0	2	0	0	2
OG0018730	0	2	0	0	2
OG0018731	0	2	0	0	2
OG0018732	0	2	0	0	2
OG0018733	0	2	0	0	2
OG0018734	0	2	0	0	2
OG0018735	0	2	0	0	2
OG0018736	0	2	0	0	2
OG0018737	0	2	0	0	2
OG0018738	0	2	0	0	2
OG0018739	0	2	0	0	2
OG0018740	0	2	0	0	2
OG0018741	0	2	0	0	2
OG0018742	0	2	0	0	2
OG0018743	0	2	0	0	2
OG0018744	0	1	0	1	2
OG0018745	0	2	0	0	2
OG0018746	0	2	0	0	2
OG0018747	0	2	0	0	2
OG0018748	0	2	0	0	2
OG0018749	0	2	0	0	2
OG0018750	0	2	0	0	2
OG0018751	0	2	0	0	2
OG0018752	0	2	0	0	2
OG0018753	0	2	0	0	2
OG0018754	0	2	0	0	2
OG0018755	0	2	0	0	2
OG0018756	0	2	0	0	2
OG0018757	0	2	0	0	2
OG0018758	0	2	0	0	2
OG0018759	0	2	0	0	2
OG0018760	0	2	0	0	2
OG0018761	0	2	0	0	2
OG0018762	0	2	0	0	2
OG0018763	0	2	0	0	2
OG0018764	0	2	0	0	2
OG0018765	0	2	0	0	2
OG0018766	0	2	0	0	2
OG0018767	0	2	0	0	2
OG0018768	0	2	0	0	2
OG0018769	0	2	0	0	2
OG0018770	0	2	0	0	2
OG0018771	0	2	0	0	2
OG0018772	0	2	0	0	2
OG0018773	0	2	0	0	2
OG0018774	0	2	0	0	2
OG0018775	0	2	0	0	2
OG0018776	0	2	0	0	2
OG0018777	0	2	0	0	2
OG0018778	0	2	0	0	2
OG0018779	0	1	1	0	2
OG0018780	0	2	0	0	2
OG0018781	0	2	0	0	2
OG0018782	0	2	0	0	2
OG0018783	0	2	0	0	2
OG0018784	0	2	0	0	2
OG0018785	0	2	0	0	2
OG0018786	0	2	0	0	2
OG0018787	0	2	0	0	2
OG0018788	0	2	0	0	2
OG0018789	0	2	0	0	2
OG0018790	0	2	0	0	2
OG0018791	0	2	0	0	2
OG0018792	0	2	0	0	2
OG0018793	0	2	0	0	2
OG0018794	0	2	0	0	2
OG0018795	0	2	0	0	2
OG0018796	0	2	0	0	2
OG0018797	0	2	0	0	2
OG0018798	0	1	0	1	2
OG0018799	0	1	0	1	2
OG0018800	0	1	1	0	2
OG0018801	0	2	0	0	2
OG0018802	0	2	0	0	2
OG0018803	0	2	0	0	2
OG0018804	0	2	0	0	2
OG0018805	0	2	0	0	2
OG0018806	0	2	0	0	2
OG0018807	0	2	0	0	2
OG0018808	0	2	0	0	2
OG0018809	0	2	0	0	2
OG0018810	0	2	0	0	2
OG0018811	0	2	0	0	2
OG0018812	0	2	0	0	2
OG0018813	0	1	1	0	2
OG0018814	0	2	0	0	2
OG0018815	0	2	0	0	2
OG0018816	0	2	0	0	2
OG0018817	0	2	0	0	2
OG0018818	0	2	0	0	2
OG0018819	0	2	0	0	2
OG0018820	0	2	0	0	2
OG0018821	0	2	0	0	2
OG0018822	0	2	0	0	2
OG0018823	0	2	0	0	2
OG0018824	0	2	0	0	2
OG0018825	0	2	0	0	2
OG0018826	0	2	0	0	2
OG0018827	0	2	0	0	2
OG0018828	0	2	0	0	2
OG0018829	0	2	0	0	2
OG0018830	0	2	0	0	2
OG0018831	0	2	0	0	2
OG0018832	0	2	0	0	2
OG0018833	0	2	0	0	2
OG0018834	0	2	0	0	2
OG0018835	0	2	0	0	2
OG0018836	0	2	0	0	2
OG0018837	0	2	0	0	2
OG0018838	0	2	0	0	2
OG0018839	0	2	0	0	2
OG0018840	0	2	0	0	2
OG0018841	0	2	0	0	2
OG0018842	0	2	0	0	2
OG0018843	0	2	0	0	2
OG0018844	0	2	0	0	2
OG0018845	0	2	0	0	2
OG0018846	0	2	0	0	2
OG0018847	0	2	0	0	2
OG0018848	0	2	0	0	2
OG0018849	0	2	0	0	2
OG0018850	0	2	0	0	2
OG0018851	0	2	0	0	2
OG0018852	0	2	0	0	2
OG0018853	0	2	0	0	2
OG0018854	0	2	0	0	2
OG0018855	0	2	0	0	2
OG0018856	0	2	0	0	2
OG0018857	0	2	0	0	2
OG0018858	0	2	0	0	2
OG0018859	0	2	0	0	2
OG0018860	0	2	0	0	2
OG0018861	0	2	0	0	2
OG0018862	0	2	0	0	2
OG0018863	0	1	1	0	2
OG0018864	0	2	0	0	2
OG0018865	0	2	0	0	2
OG0018866	0	2	0	0	2
OG0018867	0	2	0	0	2
OG0018868	0	2	0	0	2
OG0018869	0	2	0	0	2
OG0018870	0	2	0	0	2
OG0018871	0	2	0	0	2
OG0018872	0	2	0	0	2
OG0018873	0	2	0	0	2
OG0018874	0	2	0	0	2
OG0018875	0	2	0	0	2
OG0018876	0	2	0	0	2
OG0018877	0	2	0	0	2
OG0018878	0	2	0	0	2
OG0018879	0	2	0	0	2
OG0018880	0	2	0	0	2
OG0018881	0	2	0	0	2
OG0018882	0	2	0	0	2
OG0018883	0	2	0	0	2
OG0018884	0	2	0	0	2
OG0018885	0	2	0	0	2
OG0018886	0	2	0	0	2
OG0018887	0	2	0	0	2
OG0018888	0	2	0	0	2
OG0018889	0	2	0	0	2
OG0018890	0	2	0	0	2
OG0018891	0	2	0	0	2
OG0018892	0	2	0	0	2
OG0018893	0	2	0	0	2
OG0018894	0	2	0	0	2
OG0018895	0	2	0	0	2
OG0018896	0	2	0	0	2
OG0018897	0	2	0	0	2
OG0018898	0	2	0	0	2
OG0018899	0	2	0	0	2
OG0018900	0	2	0	0	2
OG0018901	0	2	0	0	2
OG0018902	0	2	0	0	2
OG0018903	0	2	0	0	2
OG0018904	0	2	0	0	2
OG0018905	0	2	0	0	2
OG0018906	0	2	0	0	2
OG0018907	0	2	0	0	2
OG0018908	0	2	0	0	2
OG0018909	0	2	0	0	2
OG0018910	0	2	0	0	2
OG0018911	0	2	0	0	2
OG0018912	0	2	0	0	2
OG0018913	0	2	0	0	2
OG0018914	0	2	0	0	2
OG0018915	0	2	0	0	2
OG0018916	0	2	0	0	2
OG0018917	0	2	0	0	2
OG0018918	0	2	0	0	2
OG0018919	0	2	0	0	2
OG0018920	0	2	0	0	2
OG0018921	0	2	0	0	2
OG0018922	0	2	0	0	2
OG0018923	0	2	0	0	2
OG0018924	0	2	0	0	2
OG0018925	0	2	0	0	2
OG0018926	0	2	0	0	2
OG0018927	0	2	0	0	2
OG0018928	0	2	0	0	2
OG0018929	0	2	0	0	2
OG0018930	0	2	0	0	2
OG0018931	0	2	0	0	2
OG0018932	0	2	0	0	2
OG0018933	0	2	0	0	2
OG0018934	0	2	0	0	2
OG0018935	0	2	0	0	2
OG0018936	0	2	0	0	2
OG0018937	0	2	0	0	2
OG0018938	0	2	0	0	2
OG0018939	0	2	0	0	2
OG0018940	0	2	0	0	2
OG0018941	0	2	0	0	2
OG0018942	0	2	0	0	2
OG0018943	0	2	0	0	2
OG0018944	0	2	0	0	2
OG0018945	0	2	0	0	2
OG0018946	0	2	0	0	2
OG0018947	0	2	0	0	2
OG0018948	0	2	0	0	2
OG0018949	0	2	0	0	2
OG0018950	0	2	0	0	2
OG0018951	0	2	0	0	2
OG0018952	0	2	0	0	2
OG0018953	0	2	0	0	2
OG0018954	0	2	0	0	2
OG0018955	0	2	0	0	2
OG0018956	0	2	0	0	2
OG0018957	0	2	0	0	2
OG0018958	0	2	0	0	2
OG0018959	0	2	0	0	2
OG0018960	0	2	0	0	2
OG0018961	0	2	0	0	2
OG0018962	0	2	0	0	2
OG0018963	0	2	0	0	2
OG0018964	0	2	0	0	2
OG0018965	0	2	0	0	2
OG0018966	0	2	0	0	2
OG0018967	0	2	0	0	2
OG0018968	0	2	0	0	2
OG0018969	0	2	0	0	2
OG0018970	0	1	0	1	2
OG0018971	0	2	0	0	2
OG0018972	0	2	0	0	2
OG0018973	0	2	0	0	2
OG0018974	0	2	0	0	2
OG0018975	0	2	0	0	2
OG0018976	0	2	0	0	2
OG0018977	0	2	0	0	2
OG0018978	0	2	0	0	2
OG0018979	0	2	0	0	2
OG0018980	0	2	0	0	2
OG0018981	0	2	0	0	2
OG0018982	0	2	0	0	2
OG0018983	0	2	0	0	2
OG0018984	0	1	1	0	2
OG0018985	0	2	0	0	2
OG0018986	0	2	0	0	2
OG0018987	0	2	0	0	2
OG0018988	0	2	0	0	2
OG0018989	0	2	0	0	2
OG0018990	0	2	0	0	2
OG0018991	0	2	0	0	2
OG0018992	0	2	0	0	2
OG0018993	0	2	0	0	2
OG0018994	0	2	0	0	2
OG0018995	0	2	0	0	2
OG0018996	0	2	0	0	2
OG0018997	0	1	1	0	2
OG0018998	0	2	0	0	2
OG0018999	0	2	0	0	2
OG0019000	0	2	0	0	2
OG0019001	0	2	0	0	2
OG0019002	0	2	0	0	2
OG0019003	0	2	0	0	2
OG0019004	0	2	0	0	2
OG0019005	0	2	0	0	2
OG0019006	0	2	0	0	2
OG0019007	0	2	0	0	2
OG0019008	0	2	0	0	2
OG0019009	0	1	1	0	2
OG0019010	0	2	0	0	2
OG0019011	0	2	0	0	2
OG0019012	0	2	0	0	2
OG0019013	0	2	0	0	2
OG0019014	0	2	0	0	2
OG0019015	0	2	0	0	2
OG0019016	0	2	0	0	2
OG0019017	0	2	0	0	2
OG0019018	0	2	0	0	2
OG0019019	0	2	0	0	2
OG0019020	0	2	0	0	2
OG0019021	0	2	0	0	2
OG0019022	0	2	0	0	2
OG0019023	0	2	0	0	2
OG0019024	0	2	0	0	2
OG0019025	0	2	0	0	2
OG0019026	0	2	0	0	2
OG0019027	0	2	0	0	2
OG0019028	0	2	0	0	2
OG0019029	0	1	1	0	2
OG0019030	0	1	1	0	2
OG0019031	0	2	0	0	2
OG0019032	0	1	1	0	2
OG0019033	0	1	1	0	2
OG0019034	0	1	1	0	2
OG0019035	0	2	0	0	2
OG0019036	0	2	0	0	2
OG0019037	0	2	0	0	2
OG0019038	0	2	0	0	2
OG0019039	0	2	0	0	2
OG0019040	0	2	0	0	2
OG0019041	0	2	0	0	2
OG0019042	0	2	0	0	2
OG0019043	0	2	0	0	2
OG0019044	0	2	0	0	2
OG0019045	0	2	0	0	2
OG0019046	0	2	0	0	2
OG0019047	0	2	0	0	2
OG0019048	0	2	0	0	2
OG0019049	0	2	0	0	2
OG0019050	0	2	0	0	2
OG0019051	0	2	0	0	2
OG0019052	0	2	0	0	2
OG0019053	0	2	0	0	2
OG0019054	0	2	0	0	2
OG0019055	0	2	0	0	2
OG0019056	0	2	0	0	2
OG0019057	0	2	0	0	2
OG0019058	0	2	0	0	2
OG0019059	0	2	0	0	2
OG0019060	0	2	0	0	2
OG0019061	0	2	0	0	2
OG0019062	0	2	0	0	2
OG0019063	0	2	0	0	2
OG0019064	0	2	0	0	2
OG0019065	0	2	0	0	2
OG0019066	0	2	0	0	2
OG0019067	0	2	0	0	2
OG0019068	0	2	0	0	2
OG0019069	0	2	0	0	2
OG0019070	0	2	0	0	2
OG0019071	0	2	0	0	2
OG0019072	0	2	0	0	2
OG0019073	0	2	0	0	2
OG0019074	0	1	1	0	2
OG0019075	0	1	1	0	2
OG0019076	0	2	0	0	2
OG0019077	0	1	1	0	2
OG0019078	0	2	0	0	2
OG0019079	0	1	1	0	2
OG0019080	0	2	0	0	2
OG0019081	0	2	0	0	2
OG0019082	0	2	0	0	2
OG0019083	0	2	0	0	2
OG0019084	0	2	0	0	2
OG0019085	0	2	0	0	2
OG0019086	0	2	0	0	2
OG0019087	0	1	1	0	2
OG0019088	0	2	0	0	2
OG0019089	0	2	0	0	2
OG0019090	0	2	0	0	2
OG0019091	0	2	0	0	2
OG0019092	0	1	1	0	2
OG0019093	0	1	1	0	2
OG0019094	0	2	0	0	2
OG0019095	0	2	0	0	2
OG0019096	0	2	0	0	2
OG0019097	0	2	0	0	2
OG0019098	0	2	0	0	2
OG0019099	0	2	0	0	2
OG0019100	0	2	0	0	2
OG0019101	0	2	0	0	2
OG0019102	0	2	0	0	2
OG0019103	0	2	0	0	2
OG0019104	0	2	0	0	2
OG0019105	0	2	0	0	2
OG0019106	0	2	0	0	2
OG0019107	0	2	0	0	2
OG0019108	0	2	0	0	2
OG0019109	0	2	0	0	2
OG0019110	0	2	0	0	2
OG0019111	0	2	0	0	2
OG0019112	0	2	0	0	2
OG0019113	0	2	0	0	2
OG0019114	0	1	1	0	2
OG0019115	0	1	0	1	2
OG0019116	0	2	0	0	2
OG0019117	0	2	0	0	2
OG0019118	0	2	0	0	2
OG0019119	0	2	0	0	2
OG0019120	0	2	0	0	2
OG0019121	0	2	0	0	2
OG0019122	0	2	0	0	2
OG0019123	0	2	0	0	2
OG0019124	0	2	0	0	2
OG0019125	0	2	0	0	2
OG0019126	0	2	0	0	2
OG0019127	0	2	0	0	2
OG0019128	0	2	0	0	2
OG0019129	0	2	0	0	2
OG0019130	0	2	0	0	2
OG0019131	0	2	0	0	2
OG0019132	0	2	0	0	2
OG0019133	0	2	0	0	2
OG0019134	0	2	0	0	2
OG0019135	0	2	0	0	2
OG0019136	0	2	0	0	2
OG0019137	0	2	0	0	2
OG0019138	0	2	0	0	2
OG0019139	0	2	0	0	2
OG0019140	0	2	0	0	2
OG0019141	0	2	0	0	2
OG0019142	0	2	0	0	2
OG0019143	0	2	0	0	2
OG0019144	0	2	0	0	2
OG0019145	0	2	0	0	2
OG0019146	0	2	0	0	2
OG0019147	0	2	0	0	2
OG0019148	0	2	0	0	2
OG0019149	0	2	0	0	2
OG0019150	0	2	0	0	2
OG0019151	0	2	0	0	2
OG0019152	0	2	0	0	2
OG0019153	0	2	0	0	2
OG0019154	0	2	0	0	2
OG0019155	0	2	0	0	2
OG0019156	0	2	0	0	2
OG0019157	0	2	0	0	2
OG0019158	0	2	0	0	2
OG0019159	0	2	0	0	2
OG0019160	0	2	0	0	2
OG0019161	0	2	0	0	2
OG0019162	0	2	0	0	2
OG0019163	0	2	0	0	2
OG0019164	0	2	0	0	2
OG0019165	0	2	0	0	2
OG0019166	0	2	0	0	2
OG0019167	0	2	0	0	2
OG0019168	0	2	0	0	2
OG0019169	0	2	0	0	2
OG0019170	0	2	0	0	2
OG0019171	0	2	0	0	2
OG0019172	0	1	1	0	2
OG0019173	0	2	0	0	2
OG0019174	0	1	0	1	2
OG0019175	0	2	0	0	2
OG0019176	0	1	0	1	2
OG0019177	0	2	0	0	2
OG0019178	0	2	0	0	2
OG0019179	0	2	0	0	2
OG0019180	0	2	0	0	2
OG0019181	0	2	0	0	2
OG0019182	0	2	0	0	2
OG0019183	0	2	0	0	2
OG0019184	0	2	0	0	2
OG0019185	0	2	0	0	2
OG0019186	0	2	0	0	2
OG0019187	0	2	0	0	2
OG0019188	0	2	0	0	2
OG0019189	0	2	0	0	2
OG0019190	0	2	0	0	2
OG0019191	0	2	0	0	2
OG0019192	0	2	0	0	2
OG0019193	0	2	0	0	2
OG0019194	0	2	0	0	2
OG0019195	0	2	0	0	2
OG0019196	0	2	0	0	2
OG0019197	0	2	0	0	2
OG0019198	0	2	0	0	2
OG0019199	0	2	0	0	2
OG0019200	0	2	0	0	2
OG0019201	0	2	0	0	2
OG0019202	0	2	0	0	2
OG0019203	0	2	0	0	2
OG0019204	0	2	0	0	2
OG0019205	0	2	0	0	2
OG0019206	0	2	0	0	2
OG0019207	0	2	0	0	2
OG0019208	0	2	0	0	2
OG0019209	0	2	0	0	2
OG0019210	0	2	0	0	2
OG0019211	0	2	0	0	2
OG0019212	0	2	0	0	2
OG0019213	0	2	0	0	2
OG0019214	0	2	0	0	2
OG0019215	0	2	0	0	2
OG0019216	0	2	0	0	2
OG0019217	0	2	0	0	2
OG0019218	0	2	0	0	2
OG0019219	0	2	0	0	2
OG0019220	0	2	0	0	2
OG0019221	0	2	0	0	2
OG0019222	0	2	0	0	2
OG0019223	0	1	0	1	2
OG0019224	0	2	0	0	2
OG0019225	0	2	0	0	2
OG0019226	0	2	0	0	2
OG0019227	0	2	0	0	2
OG0019228	0	2	0	0	2
OG0019229	0	2	0	0	2
OG0019230	0	2	0	0	2
OG0019231	0	2	0	0	2
OG0019232	0	2	0	0	2
OG0019233	0	2	0	0	2
OG0019234	0	2	0	0	2
OG0019235	0	2	0	0	2
OG0019236	0	2	0	0	2
OG0019237	0	2	0	0	2
OG0019238	0	2	0	0	2
OG0019239	0	2	0	0	2
OG0019240	0	1	0	1	2
OG0019241	0	2	0	0	2
OG0019242	0	1	1	0	2
OG0019243	0	2	0	0	2
OG0019244	0	2	0	0	2
OG0019245	0	2	0	0	2
OG0019246	0	2	0	0	2
OG0019247	0	1	0	1	2
OG0019248	0	2	0	0	2
OG0019249	0	2	0	0	2
OG0019250	0	2	0	0	2
OG0019251	0	1	1	0	2
OG0019252	0	2	0	0	2
OG0019253	0	2	0	0	2
OG0019254	0	2	0	0	2
OG0019255	0	2	0	0	2
OG0019256	0	2	0	0	2
OG0019257	0	1	0	1	2
OG0019258	0	2	0	0	2
OG0019259	0	2	0	0	2
OG0019260	0	1	0	1	2
OG0019261	0	1	1	0	2
OG0019262	0	2	0	0	2
OG0019263	0	2	0	0	2
OG0019264	0	1	1	0	2
OG0019265	0	2	0	0	2
OG0019266	0	2	0	0	2
OG0019267	0	2	0	0	2
OG0019268	0	2	0	0	2
OG0019269	0	2	0	0	2
OG0019270	0	2	0	0	2
OG0019271	0	2	0	0	2
OG0019272	0	2	0	0	2
OG0019273	0	2	0	0	2
OG0019274	0	2	0	0	2
OG0019275	0	2	0	0	2
OG0019276	0	2	0	0	2
OG0019277	0	2	0	0	2
OG0019278	0	2	0	0	2
OG0019279	0	1	1	0	2
OG0019280	0	2	0	0	2
OG0019281	0	2	0	0	2
OG0019282	0	2	0	0	2
OG0019283	0	2	0	0	2
OG0019284	0	2	0	0	2
OG0019285	0	2	0	0	2
OG0019286	0	2	0	0	2
OG0019287	0	2	0	0	2
OG0019288	0	2	0	0	2
OG0019289	0	2	0	0	2
OG0019290	0	2	0	0	2
OG0019291	0	2	0	0	2
OG0019292	0	2	0	0	2
OG0019293	0	2	0	0	2
OG0019294	0	2	0	0	2
OG0019295	0	2	0	0	2
OG0019296	0	2	0	0	2
OG0019297	0	2	0	0	2
OG0019298	0	2	0	0	2
OG0019299	0	2	0	0	2
OG0019300	0	1	0	1	2
OG0019301	0	2	0	0	2
OG0019302	0	1	1	0	2
OG0019303	0	2	0	0	2
OG0019304	0	2	0	0	2
OG0019305	0	2	0	0	2
OG0019306	0	2	0	0	2
OG0019307	0	2	0	0	2
OG0019308	0	2	0	0	2
OG0019309	0	2	0	0	2
OG0019310	0	1	0	1	2
OG0019311	0	2	0	0	2
OG0019312	0	2	0	0	2
OG0019313	0	2	0	0	2
OG0019314	0	2	0	0	2
OG0019315	0	2	0	0	2
OG0019316	0	2	0	0	2
OG0019317	0	2	0	0	2
OG0019318	0	2	0	0	2
OG0019319	0	1	1	0	2
OG0019320	0	2	0	0	2
OG0019321	0	2	0	0	2
OG0019322	0	2	0	0	2
OG0019323	0	2	0	0	2
OG0019324	0	2	0	0	2
OG0019325	0	2	0	0	2
OG0019326	0	2	0	0	2
OG0019327	0	2	0	0	2
OG0019328	0	2	0	0	2
OG0019329	0	1	1	0	2
OG0019330	0	1	1	0	2
OG0019331	0	1	1	0	2
OG0019332	0	2	0	0	2
OG0019333	0	2	0	0	2
OG0019334	0	2	0	0	2
OG0019335	0	2	0	0	2
OG0019336	0	2	0	0	2
OG0019337	0	2	0	0	2
OG0019338	0	2	0	0	2
OG0019339	0	2	0	0	2
OG0019340	0	2	0	0	2
OG0019341	0	1	0	1	2
OG0019342	0	2	0	0	2
OG0019343	0	2	0	0	2
OG0019344	0	1	1	0	2
OG0019345	0	1	0	1	2
OG0019346	0	2	0	0	2
OG0019347	0	2	0	0	2
OG0019348	0	2	0	0	2
OG0019349	0	1	1	0	2
OG0019350	0	2	0	0	2
OG0019351	0	1	1	0	2
OG0019352	0	2	0	0	2
OG0019353	0	2	0	0	2
OG0019354	0	2	0	0	2
OG0019355	0	2	0	0	2
OG0019356	0	2	0	0	2
OG0019357	0	2	0	0	2
OG0019358	0	2	0	0	2
OG0019359	0	2	0	0	2
OG0019360	0	2	0	0	2
OG0019361	0	2	0	0	2
OG0019362	0	2	0	0	2
OG0019363	0	2	0	0	2
OG0019364	0	2	0	0	2
OG0019365	0	2	0	0	2
OG0019366	0	2	0	0	2
OG0019367	0	2	0	0	2
OG0019368	0	2	0	0	2
OG0019369	0	2	0	0	2
OG0019370	0	2	0	0	2
OG0019371	0	2	0	0	2
OG0019372	0	2	0	0	2
OG0019373	0	2	0	0	2
OG0019374	0	2	0	0	2
OG0019375	0	2	0	0	2
OG0019376	0	2	0	0	2
OG0019377	0	2	0	0	2
OG0019378	0	2	0	0	2
OG0019379	0	2	0	0	2
OG0019380	0	2	0	0	2
OG0019381	0	2	0	0	2
OG0019382	0	2	0	0	2
OG0019383	0	2	0	0	2
OG0019384	0	2	0	0	2
OG0019385	0	2	0	0	2
OG0019386	0	1	1	0	2
OG0019387	0	1	1	0	2
OG0019388	0	2	0	0	2
OG0019389	0	2	0	0	2
OG0019390	0	2	0	0	2
OG0019391	0	2	0	0	2
OG0019392	0	2	0	0	2
OG0019393	0	2	0	0	2
OG0019394	0	2	0	0	2
OG0019395	0	2	0	0	2
OG0019396	0	2	0	0	2
OG0019397	0	2	0	0	2
OG0019398	0	2	0	0	2
OG0019399	0	2	0	0	2
OG0019400	0	2	0	0	2
OG0019401	0	2	0	0	2
OG0019402	0	2	0	0	2
OG0019403	0	2	0	0	2
OG0019404	0	1	1	0	2
OG0019405	0	1	1	0	2
OG0019406	0	2	0	0	2
OG0019407	0	2	0	0	2
OG0019408	0	2	0	0	2
OG0019409	0	2	0	0	2
OG0019410	0	2	0	0	2
OG0019411	0	2	0	0	2
OG0019412	0	2	0	0	2
OG0019413	0	2	0	0	2
OG0019414	0	2	0	0	2
OG0019415	0	2	0	0	2
OG0019416	0	2	0	0	2
OG0019417	0	2	0	0	2
OG0019418	0	2	0	0	2
OG0019419	0	2	0	0	2
OG0019420	0	1	1	0	2
OG0019421	0	2	0	0	2
OG0019422	0	2	0	0	2
OG0019423	0	2	0	0	2
OG0019424	0	2	0	0	2
OG0019425	0	2	0	0	2
OG0019426	0	2	0	0	2
OG0019427	0	2	0	0	2
OG0019428	0	2	0	0	2
OG0019429	0	2	0	0	2
OG0019430	0	2	0	0	2
OG0019431	0	2	0	0	2
OG0019432	0	2	0	0	2
OG0019433	0	1	1	0	2
OG0019434	0	2	0	0	2
OG0019435	0	2	0	0	2
OG0019436	0	1	1	0	2
OG0019437	0	1	1	0	2
OG0019438	0	2	0	0	2
OG0019439	0	2	0	0	2
OG0019440	0	2	0	0	2
OG0019441	0	2	0	0	2
OG0019442	0	2	0	0	2
OG0019443	0	1	1	0	2
OG0019444	0	1	1	0	2
OG0019445	0	2	0	0	2
OG0019446	0	2	0	0	2
OG0019447	0	2	0	0	2
OG0019448	0	2	0	0	2
OG0019449	0	1	1	0	2
OG0019450	0	1	1	0	2
OG0019451	0	1	1	0	2
OG0019452	0	2	0	0	2
OG0019453	0	2	0	0	2
OG0019454	0	2	0	0	2
OG0019455	0	2	0	0	2
OG0019456	0	2	0	0	2
OG0019457	0	1	0	1	2
OG0019458	0	1	1	0	2
OG0019459	0	2	0	0	2
OG0019460	0	2	0	0	2
OG0019461	0	2	0	0	2
OG0019462	0	2	0	0	2
OG0019463	0	2	0	0	2
OG0019464	0	2	0	0	2
OG0019465	0	2	0	0	2
OG0019466	0	2	0	0	2
OG0019467	0	2	0	0	2
OG0019468	0	2	0	0	2
OG0019469	0	1	1	0	2
OG0019470	0	2	0	0	2
OG0019471	0	2	0	0	2
OG0019472	0	2	0	0	2
OG0019473	0	2	0	0	2
OG0019474	0	1	1	0	2
OG0019475	0	2	0	0	2
OG0019476	0	2	0	0	2
OG0019477	0	2	0	0	2
OG0019478	0	2	0	0	2
OG0019479	0	2	0	0	2
OG0019480	0	2	0	0	2
OG0019481	0	2	0	0	2
OG0019482	0	2	0	0	2
OG0019483	0	2	0	0	2
OG0019484	0	2	0	0	2
OG0019485	0	1	1	0	2
OG0019486	0	2	0	0	2
OG0019487	0	2	0	0	2
OG0019488	0	2	0	0	2
OG0019489	0	2	0	0	2
OG0019490	0	2	0	0	2
OG0019491	0	2	0	0	2
OG0019492	0	2	0	0	2
OG0019493	0	2	0	0	2
OG0019494	0	2	0	0	2
OG0019495	0	2	0	0	2
OG0019496	0	2	0	0	2
OG0019497	0	2	0	0	2
OG0019498	0	2	0	0	2
OG0019499	0	1	0	1	2
OG0019500	0	2	0	0	2
OG0019501	0	2	0	0	2
OG0019502	0	1	0	1	2
OG0019503	0	2	0	0	2
OG0019504	0	2	0	0	2
OG0019505	0	2	0	0	2
OG0019506	0	2	0	0	2
OG0019507	0	2	0	0	2
OG0019508	0	2	0	0	2
OG0019509	0	2	0	0	2
OG0019510	0	2	0	0	2
OG0019511	0	2	0	0	2
OG0019512	0	2	0	0	2
OG0019513	0	2	0	0	2
OG0019514	0	1	1	0	2
OG0019515	0	1	1	0	2
OG0019516	0	2	0	0	2
OG0019517	0	2	0	0	2
OG0019518	0	2	0	0	2
OG0019519	0	2	0	0	2
OG0019520	0	2	0	0	2
OG0019521	0	2	0	0	2
OG0019522	0	1	1	0	2
OG0019523	0	2	0	0	2
OG0019524	0	2	0	0	2
OG0019525	0	2	0	0	2
OG0019526	0	2	0	0	2
OG0019527	0	2	0	0	2
OG0019528	0	1	1	0	2
OG0019529	0	2	0	0	2
OG0019530	0	2	0	0	2
OG0019531	0	1	1	0	2
OG0019532	0	1	1	0	2
OG0019533	0	2	0	0	2
OG0019534	0	2	0	0	2
OG0019535	0	2	0	0	2
OG0019536	0	2	0	0	2
OG0019537	0	2	0	0	2
OG0019538	0	2	0	0	2
OG0019539	0	2	0	0	2
OG0019540	0	2	0	0	2
OG0019541	0	2	0	0	2
OG0019542	0	2	0	0	2
OG0019543	0	2	0	0	2
OG0019544	0	2	0	0	2
OG0019545	0	2	0	0	2
OG0019546	0	2	0	0	2
OG0019547	0	2	0	0	2
OG0019548	0	2	0	0	2
OG0019549	0	2	0	0	2
OG0019550	0	2	0	0	2
OG0019551	0	2	0	0	2
OG0019552	0	2	0	0	2
OG0019553	0	2	0	0	2
OG0019554	0	1	1	0	2
OG0019555	0	2	0	0	2
OG0019556	0	2	0	0	2
OG0019557	0	1	1	0	2
OG0019558	0	2	0	0	2
OG0019559	0	2	0	0	2
OG0019560	0	2	0	0	2
OG0019561	0	2	0	0	2
OG0019562	0	2	0	0	2
OG0019563	0	1	1	0	2
OG0019564	0	1	1	0	2
OG0019565	0	2	0	0	2
OG0019566	0	2	0	0	2
OG0019567	0	2	0	0	2
OG0019568	0	2	0	0	2
OG0019569	0	2	0	0	2
OG0019570	0	2	0	0	2
OG0019571	0	2	0	0	2
OG0019572	0	2	0	0	2
OG0019573	0	2	0	0	2
OG0019574	0	2	0	0	2
OG0019575	0	2	0	0	2
OG0019576	0	1	1	0	2
OG0019577	0	2	0	0	2
OG0019578	0	2	0	0	2
OG0019579	0	2	0	0	2
OG0019580	0	2	0	0	2
OG0019581	0	2	0	0	2
OG0019582	0	2	0	0	2
OG0019583	0	2	0	0	2
OG0019584	0	1	0	1	2
OG0019585	0	2	0	0	2
OG0019586	0	2	0	0	2
OG0019587	0	2	0	0	2
OG0019588	0	2	0	0	2
OG0019589	0	2	0	0	2
OG0019590	0	2	0	0	2
OG0019591	0	2	0	0	2
OG0019592	0	1	1	0	2
OG0019593	0	2	0	0	2
OG0019594	0	2	0	0	2
OG0019595	0	2	0	0	2
OG0019596	0	1	0	1	2
OG0019597	0	2	0	0	2
OG0019598	0	2	0	0	2
OG0019599	0	1	1	0	2
OG0019600	0	2	0	0	2
OG0019601	0	1	1	0	2
OG0019602	0	1	1	0	2
OG0019603	0	2	0	0	2
OG0019604	0	2	0	0	2
OG0019605	0	1	0	1	2
OG0019606	0	2	0	0	2
OG0019607	0	2	0	0	2
OG0019608	0	2	0	0	2
OG0019609	0	2	0	0	2
OG0019610	0	2	0	0	2
OG0019611	0	2	0	0	2
OG0019612	0	2	0	0	2
OG0019613	0	1	1	0	2
OG0019614	0	2	0	0	2
OG0019615	0	1	1	0	2
OG0019616	0	1	1	0	2
OG0019617	0	1	1	0	2
OG0019618	0	1	1	0	2
OG0019619	0	2	0	0	2
OG0019620	0	2	0	0	2
OG0019621	0	2	0	0	2
OG0019622	0	2	0	0	2
OG0019623	0	2	0	0	2
OG0019624	0	2	0	0	2
OG0019625	0	2	0	0	2
OG0019626	0	2	0	0	2
OG0019627	0	2	0	0	2
OG0019628	0	2	0	0	2
OG0019629	0	2	0	0	2
OG0019630	0	2	0	0	2
OG0019631	0	2	0	0	2
OG0019632	0	2	0	0	2
OG0019633	0	2	0	0	2
OG0019634	0	2	0	0	2
OG0019635	0	1	1	0	2
OG0019636	0	1	1	0	2
OG0019637	0	2	0	0	2
OG0019638	0	2	0	0	2
OG0019639	0	1	0	1	2
OG0019640	0	2	0	0	2
OG0019641	0	2	0	0	2
OG0019642	0	2	0	0	2
OG0019643	0	2	0	0	2
OG0019644	0	2	0	0	2
OG0019645	0	2	0	0	2
OG0019646	0	2	0	0	2
OG0019647	0	2	0	0	2
OG0019648	0	2	0	0	2
OG0019649	0	2	0	0	2
OG0019650	0	2	0	0	2
OG0019651	0	2	0	0	2
OG0019652	0	2	0	0	2
OG0019653	0	2	0	0	2
OG0019654	0	2	0	0	2
OG0019655	0	2	0	0	2
OG0019656	0	2	0	0	2
OG0019657	0	2	0	0	2
OG0019658	0	2	0	0	2
OG0019659	0	2	0	0	2
OG0019660	0	2	0	0	2
OG0019661	0	1	0	1	2
OG0019662	0	2	0	0	2
OG0019663	0	2	0	0	2
OG0019664	0	2	0	0	2
OG0019665	0	2	0	0	2
OG0019666	0	2	0	0	2
OG0019667	0	2	0	0	2
OG0019668	0	2	0	0	2
OG0019669	0	2	0	0	2
OG0019670	0	2	0	0	2
OG0019671	0	2	0	0	2
OG0019672	0	2	0	0	2
OG0019673	0	2	0	0	2
OG0019674	0	2	0	0	2
OG0019675	0	2	0	0	2
OG0019676	0	2	0	0	2
OG0019677	0	2	0	0	2
OG0019678	0	2	0	0	2
OG0019679	0	2	0	0	2
OG0019680	0	2	0	0	2
OG0019681	0	2	0	0	2
OG0019682	0	2	0	0	2
OG0019683	0	2	0	0	2
OG0019684	0	2	0	0	2
OG0019685	0	2	0	0	2
OG0019686	0	2	0	0	2
OG0019687	0	2	0	0	2
OG0019688	0	2	0	0	2
OG0019689	0	1	0	1	2
OG0019690	0	0	2	0	2
OG0019691	0	0	2	0	2
OG0019692	0	0	2	0	2
OG0019693	0	0	2	0	2
OG0019694	0	0	2	0	2
OG0019695	0	0	2	0	2
OG0019696	0	0	2	0	2
OG0019697	0	0	2	0	2
OG0019698	0	0	2	0	2
OG0019699	0	0	2	0	2
OG0019700	0	0	2	0	2
OG0019701	0	0	2	0	2
OG0019702	0	0	2	0	2
OG0019703	0	0	2	0	2
OG0019704	0	0	2	0	2
OG0019705	0	0	2	0	2
OG0019706	0	0	2	0	2
OG0019707	0	0	2	0	2
OG0019708	0	0	2	0	2
OG0019709	0	0	2	0	2
OG0019710	0	0	2	0	2
OG0019711	0	0	2	0	2
OG0019712	0	0	2	0	2
OG0019713	0	0	2	0	2
OG0019714	0	0	2	0	2
OG0019715	0	0	2	0	2
OG0019716	0	0	2	0	2
OG0019717	0	0	2	0	2
OG0019718	0	0	2	0	2
OG0019719	0	0	1	1	2
OG0019720	0	0	2	0	2
OG0019721	0	0	2	0	2
OG0019722	0	0	2	0	2
OG0019723	0	0	2	0	2
OG0019724	0	0	2	0	2
OG0019725	0	0	2	0	2
OG0019726	0	0	2	0	2
OG0019727	0	0	2	0	2
OG0019728	0	0	2	0	2
OG0019729	0	0	2	0	2
OG0019730	0	0	2	0	2
OG0019731	0	0	2	0	2
OG0019732	0	0	2	0	2
OG0019733	0	0	2	0	2
OG0019734	0	0	2	0	2
OG0019735	0	0	2	0	2
OG0019736	0	0	2	0	2
OG0019737	0	0	2	0	2
OG0019738	0	0	2	0	2
OG0019739	0	0	2	0	2
OG0019740	0	0	2	0	2
OG0019741	0	0	2	0	2
OG0019742	0	0	2	0	2
OG0019743	0	0	2	0	2
OG0019744	0	0	2	0	2
OG0019745	0	0	2	0	2
OG0019746	0	0	2	0	2
OG0019747	0	0	2	0	2
OG0019748	0	0	2	0	2
OG0019749	0	0	2	0	2
OG0019750	0	0	2	0	2
OG0019751	0	0	2	0	2
OG0019752	0	0	2	0	2
OG0019753	0	0	2	0	2
OG0019754	0	0	2	0	2
OG0019755	0	0	2	0	2
OG0019756	0	0	2	0	2
OG0019757	0	0	2	0	2
OG0019758	0	0	2	0	2
OG0019759	0	0	2	0	2
OG0019760	0	0	2	0	2
OG0019761	0	0	2	0	2
OG0019762	0	0	2	0	2
OG0019763	0	0	2	0	2
OG0019764	0	0	2	0	2
OG0019765	0	0	2	0	2
OG0019766	0	0	2	0	2
OG0019767	0	0	2	0	2
OG0019768	0	0	2	0	2
OG0019769	0	0	2	0	2
OG0019770	0	0	2	0	2
OG0019771	0	0	2	0	2
OG0019772	0	0	2	0	2
OG0019773	0	0	2	0	2
OG0019774	0	0	2	0	2
OG0019775	0	0	2	0	2
OG0019776	0	0	2	0	2
OG0019777	0	0	2	0	2
OG0019778	0	0	2	0	2
OG0019779	0	0	2	0	2
OG0019780	0	0	2	0	2
OG0019781	0	0	2	0	2
OG0019782	0	0	2	0	2
OG0019783	0	0	2	0	2
OG0019784	0	0	2	0	2
OG0019785	0	0	2	0	2
OG0019786	0	0	2	0	2
OG0019787	0	0	2	0	2
OG0019788	0	0	2	0	2
OG0019789	0	0	2	0	2
OG0019790	0	0	2	0	2
OG0019791	0	0	2	0	2
OG0019792	0	0	2	0	2
OG0019793	0	0	2	0	2
OG0019794	0	0	2	0	2
OG0019795	0	0	2	0	2
OG0019796	0	0	2	0	2
OG0019797	0	0	2	0	2
OG0019798	0	0	2	0	2
OG0019799	0	0	2	0	2
OG0019800	0	0	2	0	2
OG0019801	0	0	2	0	2
OG0019802	0	0	2	0	2
OG0019803	0	0	2	0	2
OG0019804	0	0	2	0	2
OG0019805	0	0	2	0	2
OG0019806	0	0	2	0	2
OG0019807	0	0	2	0	2
OG0019808	0	0	2	0	2
OG0019809	0	0	2	0	2
OG0019810	0	0	2	0	2
OG0019811	0	0	2	0	2
OG0019812	0	0	2	0	2
OG0019813	0	0	2	0	2
OG0019814	0	0	2	0	2
OG0019815	0	0	2	0	2
OG0019816	0	0	2	0	2
OG0019817	0	0	2	0	2
OG0019818	0	0	1	1	2
OG0019819	0	0	2	0	2
OG0019820	0	0	2	0	2
OG0019821	0	0	2	0	2
OG0019822	0	0	2	0	2
OG0019823	0	0	2	0	2
OG0019824	0	0	2	0	2
OG0019825	0	0	2	0	2
OG0019826	0	0	2	0	2
OG0019827	0	0	2	0	2
OG0019828	0	0	2	0	2
OG0019829	0	0	2	0	2
OG0019830	0	0	2	0	2
OG0019831	0	0	2	0	2
OG0019832	0	0	2	0	2
OG0019833	0	0	2	0	2
OG0019834	0	0	2	0	2
OG0019835	0	0	2	0	2
OG0019836	0	0	2	0	2
OG0019837	0	0	2	0	2
OG0019838	0	0	2	0	2
OG0019839	0	0	2	0	2
OG0019840	0	0	2	0	2
OG0019841	0	0	2	0	2
OG0019842	0	0	2	0	2
OG0019843	0	0	2	0	2
OG0019844	0	0	2	0	2
OG0019845	0	0	2	0	2
OG0019846	0	0	2	0	2
OG0019847	0	0	2	0	2
OG0019848	0	0	2	0	2
OG0019849	0	0	2	0	2
OG0019850	0	0	2	0	2
OG0019851	0	0	2	0	2
OG0019852	0	0	2	0	2
OG0019853	0	0	2	0	2
OG0019854	0	0	2	0	2
OG0019855	0	0	2	0	2
OG0019856	0	0	2	0	2
OG0019857	0	0	2	0	2
OG0019858	0	0	2	0	2
OG0019859	0	0	2	0	2
OG0019860	0	0	2	0	2
OG0019861	0	0	2	0	2
OG0019862	0	0	2	0	2
OG0019863	0	0	2	0	2
OG0019864	0	0	2	0	2
OG0019865	0	0	2	0	2
OG0019866	0	0	2	0	2
OG0019867	0	0	2	0	2
OG0019868	0	0	2	0	2
OG0019869	0	0	2	0	2
OG0019870	0	0	2	0	2
OG0019871	0	0	2	0	2
OG0019872	0	0	2	0	2
OG0019873	0	0	2	0	2
OG0019874	0	0	2	0	2
OG0019875	0	0	2	0	2
OG0019876	0	0	2	0	2
OG0019877	0	0	2	0	2
OG0019878	0	0	2	0	2
OG0019879	0	0	2	0	2
OG0019880	0	0	2	0	2
OG0019881	0	0	2	0	2
OG0019882	0	0	2	0	2
OG0019883	0	0	2	0	2
OG0019884	0	0	2	0	2
OG0019885	0	0	2	0	2
OG0019886	0	0	2	0	2
OG0019887	0	0	2	0	2
OG0019888	0	0	2	0	2
OG0019889	0	0	2	0	2
OG0019890	0	0	2	0	2
OG0019891	0	0	2	0	2
OG0019892	0	0	2	0	2
OG0019893	0	0	2	0	2
OG0019894	0	0	2	0	2
OG0019895	0	0	2	0	2
OG0019896	0	0	2	0	2
OG0019897	0	0	2	0	2
OG0019898	0	0	2	0	2
OG0019899	0	0	2	0	2
OG0019900	0	0	2	0	2
OG0019901	0	0	2	0	2
OG0019902	0	0	2	0	2
OG0019903	0	0	2	0	2
OG0019904	0	0	2	0	2
OG0019905	0	0	2	0	2
OG0019906	0	0	2	0	2
OG0019907	0	0	2	0	2
OG0019908	0	0	2	0	2
OG0019909	0	0	2	0	2
OG0019910	0	0	2	0	2
OG0019911	0	0	2	0	2
OG0019912	0	0	2	0	2
OG0019913	0	0	2	0	2
OG0019914	0	0	2	0	2
OG0019915	0	0	2	0	2
OG0019916	0	0	2	0	2
OG0019917	0	0	2	0	2
OG0019918	0	0	2	0	2
OG0019919	0	0	2	0	2
OG0019920	0	0	2	0	2
OG0019921	0	0	2	0	2
OG0019922	0	0	2	0	2
OG0019923	0	0	2	0	2
OG0019924	0	0	2	0	2
OG0019925	0	0	2	0	2
OG0019926	0	0	2	0	2
OG0019927	0	0	2	0	2
OG0019928	0	0	2	0	2
OG0019929	0	0	2	0	2
OG0019930	0	0	2	0	2
OG0019931	0	0	2	0	2
OG0019932	0	0	2	0	2
OG0019933	0	0	2	0	2
OG0019934	0	0	2	0	2
OG0019935	0	0	2	0	2
OG0019936	0	0	2	0	2
OG0019937	0	0	2	0	2
OG0019938	0	0	2	0	2
OG0019939	0	0	2	0	2
OG0019940	0	0	2	0	2
OG0019941	0	0	2	0	2
OG0019942	0	0	2	0	2
OG0019943	0	0	2	0	2
OG0019944	0	0	2	0	2
OG0019945	0	0	2	0	2
OG0019946	0	0	2	0	2
OG0019947	0	0	2	0	2
OG0019948	0	0	2	0	2
OG0019949	0	0	2	0	2
OG0019950	0	0	2	0	2
OG0019951	0	0	2	0	2
OG0019952	0	0	2	0	2
OG0019953	0	0	2	0	2
OG0019954	0	0	2	0	2
OG0019955	0	0	2	0	2
OG0019956	0	0	2	0	2
OG0019957	0	0	2	0	2
OG0019958	0	0	2	0	2
OG0019959	0	0	2	0	2
OG0019960	0	0	2	0	2
OG0019961	0	0	2	0	2
OG0019962	0	0	1	1	2
OG0019963	0	0	2	0	2
OG0019964	0	0	2	0	2
OG0019965	0	0	2	0	2
OG0019966	0	0	2	0	2
OG0019967	0	0	2	0	2
OG0019968	0	0	2	0	2
OG0019969	0	0	2	0	2
OG0019970	0	0	2	0	2
OG0019971	0	0	2	0	2
OG0019972	0	0	2	0	2
OG0019973	0	0	2	0	2
OG0019974	0	0	2	0	2
OG0019975	0	0	2	0	2
OG0019976	0	0	2	0	2
OG0019977	0	0	2	0	2
OG0019978	0	0	2	0	2
OG0019979	0	0	2	0	2
OG0019980	0	0	2	0	2
OG0019981	0	0	2	0	2
OG0019982	0	0	2	0	2
OG0019983	0	0	2	0	2
OG0019984	0	0	2	0	2
OG0019985	0	0	2	0	2
OG0019986	0	0	2	0	2
OG0019987	0	0	2	0	2
OG0019988	0	0	2	0	2
OG0019989	0	0	2	0	2
OG0019990	0	0	2	0	2
OG0019991	0	0	2	0	2
OG0019992	0	0	2	0	2
OG0019993	0	0	2	0	2
OG0019994	0	0	2	0	2
OG0019995	0	0	2	0	2
OG0019996	0	0	2	0	2
OG0019997	0	0	2	0	2
OG0019998	0	0	2	0	2
OG0019999	0	0	2	0	2
OG0020000	0	0	2	0	2
OG0020001	0	0	2	0	2
OG0020002	0	0	2	0	2
OG0020003	0	0	2	0	2
OG0020004	0	0	2	0	2
OG0020005	0	0	2	0	2
OG0020006	0	0	1	1	2
OG0020007	0	0	2	0	2
OG0020008	0	0	2	0	2
OG0020009	0	0	2	0	2
OG0020010	0	0	2	0	2
OG0020011	0	0	2	0	2
OG0020012	0	0	2	0	2
OG0020013	0	0	2	0	2
OG0020014	0	0	2	0	2
OG0020015	0	0	2	0	2
OG0020016	0	0	2	0	2
OG0020017	0	0	2	0	2
OG0020018	0	0	2	0	2
OG0020019	0	0	2	0	2
OG0020020	0	0	2	0	2
OG0020021	0	0	2	0	2
OG0020022	0	0	2	0	2
OG0020023	0	0	2	0	2
OG0020024	0	0	2	0	2
OG0020025	0	0	2	0	2
OG0020026	0	0	2	0	2
OG0020027	0	0	2	0	2
OG0020028	0	0	2	0	2
OG0020029	0	0	2	0	2
OG0020030	0	0	2	0	2
OG0020031	0	0	2	0	2
OG0020032	0	0	2	0	2
OG0020033	0	0	2	0	2
OG0020034	0	0	2	0	2
OG0020035	0	0	2	0	2
OG0020036	0	0	2	0	2
OG0020037	0	0	2	0	2
OG0020038	0	0	2	0	2
OG0020039	0	0	2	0	2
OG0020040	0	0	2	0	2
OG0020041	0	0	2	0	2
OG0020042	0	0	2	0	2
OG0020043	0	0	2	0	2
OG0020044	0	0	2	0	2
OG0020045	0	0	2	0	2
OG0020046	0	0	2	0	2
OG0020047	0	0	2	0	2
OG0020048	0	0	2	0	2
OG0020049	0	0	2	0	2
OG0020050	0	0	2	0	2
OG0020051	0	0	2	0	2
OG0020052	0	0	2	0	2
OG0020053	0	0	2	0	2
OG0020054	0	0	2	0	2
OG0020055	0	0	2	0	2
OG0020056	0	0	2	0	2
OG0020057	0	0	2	0	2
OG0020058	0	0	2	0	2
OG0020059	0	0	2	0	2
OG0020060	0	0	2	0	2
OG0020061	0	0	2	0	2
OG0020062	0	0	2	0	2
OG0020063	0	0	2	0	2
OG0020064	0	0	2	0	2
OG0020065	0	0	2	0	2
OG0020066	0	0	2	0	2
OG0020067	0	0	2	0	2
OG0020068	0	0	2	0	2
OG0020069	0	0	2	0	2
OG0020070	0	0	2	0	2
OG0020071	0	0	2	0	2
OG0020072	0	0	2	0	2
OG0020073	0	0	2	0	2
OG0020074	0	0	2	0	2
OG0020075	0	0	2	0	2
OG0020076	0	0	2	0	2
OG0020077	0	0	2	0	2
OG0020078	0	0	2	0	2
OG0020079	0	0	2	0	2
OG0020080	0	0	2	0	2
OG0020081	0	0	2	0	2
OG0020082	0	0	2	0	2
OG0020083	0	0	2	0	2
OG0020084	0	0	2	0	2
OG0020085	0	0	2	0	2
OG0020086	0	0	2	0	2
OG0020087	0	0	2	0	2
OG0020088	0	0	2	0	2
OG0020089	0	0	2	0	2
OG0020090	0	0	2	0	2
OG0020091	0	0	2	0	2
OG0020092	0	0	2	0	2
OG0020093	0	0	2	0	2
OG0020094	0	0	2	0	2
OG0020095	0	0	2	0	2
OG0020096	0	0	2	0	2
OG0020097	0	0	2	0	2
OG0020098	0	0	2	0	2
OG0020099	0	0	2	0	2
OG0020100	0	0	2	0	2
OG0020101	0	0	2	0	2
OG0020102	0	0	2	0	2
OG0020103	0	0	2	0	2
OG0020104	0	0	2	0	2
OG0020105	0	0	2	0	2
OG0020106	0	0	2	0	2
OG0020107	0	0	2	0	2
OG0020108	0	0	2	0	2
OG0020109	0	0	2	0	2
OG0020110	0	0	2	0	2
OG0020111	0	0	2	0	2
OG0020112	0	0	2	0	2
OG0020113	0	0	2	0	2
OG0020114	0	0	1	1	2
OG0020115	0	0	2	0	2
OG0020116	0	0	2	0	2
OG0020117	0	0	2	0	2
OG0020118	0	0	2	0	2
OG0020119	0	0	2	0	2
OG0020120	0	0	2	0	2
OG0020121	0	0	2	0	2
OG0020122	0	0	2	0	2
OG0020123	0	0	2	0	2
OG0020124	0	0	2	0	2
OG0020125	0	0	2	0	2
OG0020126	0	0	2	0	2
OG0020127	0	0	2	0	2
OG0020128	0	0	2	0	2
OG0020129	0	0	2	0	2
OG0020130	0	0	2	0	2
OG0020131	0	0	2	0	2
OG0020132	0	0	2	0	2
OG0020133	0	0	2	0	2
OG0020134	0	0	2	0	2
OG0020135	0	0	2	0	2
OG0020136	0	0	2	0	2
OG0020137	0	0	2	0	2
OG0020138	0	0	1	1	2
OG0020139	0	0	2	0	2
OG0020140	0	0	2	0	2
OG0020141	0	0	2	0	2
OG0020142	0	0	2	0	2
OG0020143	0	0	2	0	2
OG0020144	0	0	2	0	2
OG0020145	0	0	2	0	2
OG0020146	0	0	2	0	2
OG0020147	0	0	2	0	2
OG0020148	0	0	2	0	2
OG0020149	0	0	2	0	2
OG0020150	0	0	2	0	2
OG0020151	0	0	2	0	2
OG0020152	0	0	2	0	2
OG0020153	0	0	2	0	2
OG0020154	0	0	2	0	2
OG0020155	0	0	2	0	2
OG0020156	0	0	2	0	2
OG0020157	0	0	2	0	2
OG0020158	0	0	2	0	2
OG0020159	0	0	2	0	2
OG0020160	0	0	2	0	2
OG0020161	0	0	2	0	2
OG0020162	0	0	2	0	2
OG0020163	0	0	2	0	2
OG0020164	0	0	2	0	2
OG0020165	0	0	2	0	2
OG0020166	0	0	2	0	2
OG0020167	0	0	2	0	2
OG0020168	0	0	2	0	2
OG0020169	0	0	2	0	2
OG0020170	0	0	2	0	2
OG0020171	0	0	2	0	2
OG0020172	0	0	2	0	2
OG0020173	0	0	2	0	2
OG0020174	0	0	2	0	2
OG0020175	0	0	2	0	2
OG0020176	0	0	2	0	2
OG0020177	0	0	2	0	2
OG0020178	0	0	2	0	2
OG0020179	0	0	2	0	2
OG0020180	0	0	2	0	2
OG0020181	0	0	2	0	2
OG0020182	0	0	2	0	2
OG0020183	0	0	2	0	2
OG0020184	0	0	2	0	2
OG0020185	0	0	2	0	2
OG0020186	0	0	2	0	2
OG0020187	0	0	2	0	2
OG0020188	0	0	2	0	2
OG0020189	0	0	2	0	2
OG0020190	0	0	2	0	2
OG0020191	0	0	1	1	2
OG0020192	0	0	2	0	2
OG0020193	0	0	2	0	2
OG0020194	0	0	2	0	2
OG0020195	0	0	2	0	2
OG0020196	0	0	2	0	2
OG0020197	0	0	2	0	2
OG0020198	0	0	2	0	2
OG0020199	0	0	2	0	2
OG0020200	0	0	2	0	2
OG0020201	0	0	2	0	2
OG0020202	0	0	2	0	2
OG0020203	0	0	2	0	2
OG0020204	0	0	2	0	2
OG0020205	0	0	2	0	2
OG0020206	0	0	2	0	2
OG0020207	0	0	2	0	2
OG0020208	0	0	2	0	2
OG0020209	0	0	2	0	2
OG0020210	0	0	2	0	2
OG0020211	0	0	2	0	2
OG0020212	0	0	2	0	2
OG0020213	0	0	2	0	2
OG0020214	0	0	2	0	2
OG0020215	0	0	2	0	2
OG0020216	0	0	2	0	2
OG0020217	0	0	2	0	2
OG0020218	0	0	2	0	2
OG0020219	0	0	2	0	2
OG0020220	0	0	2	0	2
OG0020221	0	0	2	0	2
OG0020222	0	0	2	0	2
OG0020223	0	0	2	0	2
OG0020224	0	0	2	0	2
OG0020225	0	0	2	0	2
OG0020226	0	0	2	0	2
OG0020227	0	0	2	0	2
OG0020228	0	0	2	0	2
OG0020229	0	0	2	0	2
OG0020230	0	0	2	0	2
OG0020231	0	0	2	0	2
OG0020232	0	0	2	0	2
OG0020233	0	0	2	0	2
OG0020234	0	0	2	0	2
OG0020235	0	0	2	0	2
OG0020236	0	0	2	0	2
OG0020237	0	0	2	0	2
OG0020238	0	0	2	0	2
OG0020239	0	0	2	0	2
OG0020240	0	0	2	0	2
OG0020241	0	0	2	0	2
OG0020242	0	0	2	0	2
OG0020243	0	0	2	0	2
OG0020244	0	0	2	0	2
OG0020245	0	0	2	0	2
OG0020246	0	0	2	0	2
OG0020247	0	0	2	0	2
OG0020248	0	0	2	0	2
OG0020249	0	0	2	0	2
OG0020250	0	0	2	0	2
OG0020251	0	0	2	0	2
OG0020252	0	0	2	0	2
OG0020253	0	0	2	0	2
OG0020254	0	0	2	0	2
OG0020255	0	0	2	0	2
OG0020256	0	0	2	0	2
OG0020257	0	0	2	0	2
OG0020258	0	0	2	0	2
OG0020259	0	0	2	0	2
OG0020260	0	0	2	0	2
OG0020261	0	0	2	0	2
OG0020262	0	0	2	0	2
OG0020263	0	0	2	0	2
OG0020264	0	0	2	0	2
OG0020265	0	0	2	0	2
OG0020266	0	0	2	0	2
OG0020267	0	0	1	1	2
OG0020268	0	0	2	0	2
OG0020269	0	0	2	0	2
OG0020270	0	0	1	1	2
OG0020271	0	0	2	0	2
OG0020272	0	0	2	0	2
OG0020273	0	0	2	0	2
OG0020274	0	0	2	0	2
OG0020275	0	0	2	0	2
OG0020276	0	0	2	0	2
OG0020277	0	0	2	0	2
OG0020278	0	0	2	0	2
OG0020279	0	0	2	0	2
OG0020280	0	0	2	0	2
OG0020281	0	0	2	0	2
OG0020282	0	0	2	0	2
OG0020283	0	0	2	0	2
OG0020284	0	0	2	0	2
OG0020285	0	0	2	0	2
OG0020286	0	0	2	0	2
OG0020287	0	0	2	0	2
OG0020288	0	0	2	0	2
OG0020289	0	0	2	0	2
OG0020290	0	0	2	0	2
OG0020291	0	0	2	0	2
OG0020292	0	0	2	0	2
OG0020293	0	0	2	0	2
OG0020294	0	0	2	0	2
OG0020295	0	0	2	0	2
OG0020296	0	0	2	0	2
OG0020297	0	0	2	0	2
OG0020298	0	0	2	0	2
OG0020299	0	0	2	0	2
OG0020300	0	0	2	0	2
OG0020301	0	0	2	0	2
OG0020302	0	0	2	0	2
OG0020303	0	0	2	0	2
OG0020304	0	0	2	0	2
OG0020305	0	0	2	0	2
OG0020306	0	0	2	0	2
OG0020307	0	0	2	0	2
OG0020308	0	0	2	0	2
OG0020309	0	0	2	0	2
OG0020310	0	0	2	0	2
OG0020311	0	0	2	0	2
OG0020312	0	0	2	0	2
OG0020313	0	0	2	0	2
OG0020314	0	0	2	0	2
OG0020315	0	0	2	0	2
OG0020316	0	0	2	0	2
OG0020317	0	0	2	0	2
OG0020318	0	0	2	0	2
OG0020319	0	0	2	0	2
OG0020320	0	0	2	0	2
OG0020321	0	0	2	0	2
OG0020322	0	0	2	0	2
OG0020323	0	0	2	0	2
OG0020324	0	0	2	0	2
OG0020325	0	0	2	0	2
OG0020326	0	0	2	0	2
OG0020327	0	0	2	0	2
OG0020328	0	0	2	0	2
OG0020329	0	0	2	0	2
OG0020330	0	0	2	0	2
OG0020331	0	0	2	0	2
OG0020332	0	0	2	0	2
OG0020333	0	0	2	0	2
OG0020334	0	0	2	0	2
OG0020335	0	0	2	0	2
OG0020336	0	0	2	0	2
OG0020337	0	0	2	0	2
OG0020338	0	0	2	0	2
OG0020339	0	0	2	0	2
OG0020340	0	0	2	0	2
OG0020341	0	0	2	0	2
OG0020342	0	0	2	0	2
OG0020343	0	0	2	0	2
OG0020344	0	0	2	0	2
OG0020345	0	0	2	0	2
OG0020346	0	0	2	0	2
OG0020347	0	0	2	0	2
OG0020348	0	0	2	0	2
OG0020349	0	0	2	0	2
OG0020350	0	0	2	0	2
OG0020351	0	0	2	0	2
OG0020352	0	0	2	0	2
OG0020353	0	0	2	0	2
OG0020354	0	0	2	0	2
OG0020355	0	0	2	0	2
OG0020356	0	0	2	0	2
OG0020357	0	0	2	0	2
OG0020358	0	0	2	0	2
OG0020359	0	0	2	0	2
OG0020360	0	0	2	0	2
OG0020361	0	0	2	0	2
OG0020362	0	0	2	0	2
OG0020363	0	0	2	0	2
OG0020364	0	0	2	0	2
OG0020365	0	0	1	1	2
OG0020366	0	0	2	0	2
OG0020367	0	0	2	0	2
OG0020368	0	0	2	0	2
OG0020369	0	0	2	0	2
OG0020370	0	0	2	0	2
OG0020371	0	0	2	0	2
OG0020372	0	0	2	0	2
OG0020373	0	0	2	0	2
OG0020374	0	0	2	0	2
OG0020375	0	0	2	0	2
OG0020376	0	0	2	0	2
OG0020377	0	0	2	0	2
OG0020378	0	0	2	0	2
OG0020379	0	0	2	0	2
OG0020380	0	0	2	0	2
OG0020381	0	0	2	0	2
OG0020382	0	0	2	0	2
OG0020383	0	0	2	0	2
OG0020384	0	0	2	0	2
OG0020385	0	0	2	0	2
OG0020386	0	0	2	0	2
OG0020387	0	0	2	0	2
OG0020388	0	0	2	0	2
OG0020389	0	0	2	0	2
OG0020390	0	0	2	0	2
OG0020391	0	0	2	0	2
OG0020392	0	0	2	0	2
OG0020393	0	0	2	0	2
OG0020394	0	0	2	0	2
OG0020395	0	0	2	0	2
OG0020396	0	0	2	0	2
OG0020397	0	0	2	0	2
OG0020398	0	0	2	0	2
OG0020399	0	0	2	0	2
OG0020400	0	0	2	0	2
OG0020401	0	0	2	0	2
OG0020402	0	0	2	0	2
OG0020403	0	0	2	0	2
OG0020404	0	0	2	0	2
OG0020405	0	0	2	0	2
OG0020406	0	0	2	0	2
OG0020407	0	0	2	0	2
OG0020408	0	0	2	0	2
OG0020409	0	0	2	0	2
OG0020410	0	0	2	0	2
OG0020411	0	0	1	1	2
OG0020412	0	0	1	1	2
OG0020413	0	0	2	0	2
OG0020414	0	0	2	0	2
OG0020415	0	0	2	0	2
OG0020416	0	0	2	0	2
OG0020417	0	0	2	0	2
OG0020418	0	0	2	0	2
OG0020419	0	0	2	0	2
OG0020420	0	0	2	0	2
OG0020421	0	0	2	0	2
OG0020422	0	0	2	0	2
OG0020423	0	0	2	0	2
OG0020424	0	0	2	0	2
OG0020425	0	0	2	0	2
OG0020426	0	0	2	0	2
OG0020427	0	0	2	0	2
OG0020428	0	0	2	0	2
OG0020429	0	0	1	1	2
OG0020430	0	0	2	0	2
OG0020431	0	0	2	0	2
OG0020432	0	0	2	0	2
OG0020433	0	0	2	0	2
OG0020434	0	0	2	0	2
OG0020435	0	0	2	0	2
OG0020436	0	0	2	0	2
OG0020437	0	0	2	0	2
OG0020438	0	0	2	0	2
OG0020439	0	0	2	0	2
OG0020440	0	0	2	0	2
OG0020441	0	0	2	0	2
OG0020442	0	0	2	0	2
OG0020443	0	0	2	0	2
OG0020444	0	0	2	0	2
OG0020445	0	0	2	0	2
OG0020446	0	0	1	1	2
OG0020447	0	0	2	0	2
OG0020448	0	0	2	0	2
OG0020449	0	0	2	0	2
OG0020450	0	0	2	0	2
OG0020451	0	0	2	0	2
OG0020452	0	0	2	0	2
OG0020453	0	0	2	0	2
OG0020454	0	0	2	0	2
OG0020455	0	0	2	0	2
OG0020456	0	0	2	0	2
OG0020457	0	0	2	0	2
OG0020458	0	0	2	0	2
OG0020459	0	0	2	0	2
OG0020460	0	0	2	0	2
OG0020461	0	0	1	1	2
OG0020462	0	0	0	2	2
OG0020463	0	0	0	2	2
OG0020464	0	0	0	2	2
OG0020465	0	0	0	2	2
OG0020466	0	0	0	2	2
OG0020467	0	0	0	2	2
OG0020468	0	0	0	2	2
OG0020469	0	0	0	2	2
OG0020470	0	0	0	2	2
OG0020471	0	0	0	2	2
OG0020472	0	0	0	2	2
OG0020473	0	0	0	2	2
OG0020474	0	0	0	2	2
OG0020475	0	0	0	2	2
OG0020476	0	0	0	2	2
OG0020477	0	0	0	2	2
OG0020478	0	0	0	2	2
OG0020479	0	0	0	2	2
OG0020480	0	0	0	2	2
OG0020481	0	0	0	2	2
OG0020482	0	0	0	2	2
OG0020483	0	0	0	2	2
OG0020484	0	0	0	2	2
OG0020485	0	0	0	2	2
OG0020486	0	0	0	2	2
OG0020487	0	0	0	2	2
OG0020488	0	0	0	2	2
OG0020489	0	0	0	2	2
OG0020490	0	0	0	2	2
OG0020491	0	0	0	2	2
OG0020492	0	0	0	2	2
OG0020493	0	0	0	2	2
OG0020494	0	0	0	2	2
OG0020495	0	0	0	2	2
OG0020496	0	0	0	2	2
OG0020497	0	0	0	2	2
OG0020498	0	0	0	2	2
OG0020499	0	0	0	2	2
OG0020500	0	0	0	2	2
OG0020501	0	0	0	2	2
OG0020502	0	0	0	2	2
OG0020503	0	0	0	2	2
OG0020504	0	0	0	2	2
OG0020505	0	0	0	2	2
OG0020506	0	0	0	2	2
OG0020507	0	0	0	2	2
OG0020508	0	0	0	2	2
OG0020509	0	0	0	2	2
OG0020510	0	0	0	2	2
OG0020511	0	0	0	2	2
OG0020512	0	0	0	2	2
OG0020513	0	0	0	2	2
OG0020514	0	0	0	2	2
OG0020515	0	0	0	2	2
OG0020516	0	0	0	2	2
OG0020517	0	0	0	2	2
OG0020518	0	0	0	2	2
OG0020519	0	0	0	2	2
OG0020520	0	0	0	2	2
OG0020521	0	0	0	2	2
OG0020522	0	0	0	2	2
OG0020523	0	0	0	2	2
OG0020524	0	0	0	2	2
OG0020525	0	0	0	2	2
OG0020526	0	0	0	2	2
OG0020527	0	0	0	2	2
OG0020528	0	0	0	2	2
OG0020529	0	0	0	2	2
OG0020530	0	0	0	2	2
OG0020531	0	0	0	2	2
OG0020532	0	0	0	2	2
OG0020533	0	0	0	2	2
OG0020534	0	0	0	2	2
OG0020535	0	0	0	2	2
OG0020536	0	0	0	2	2
OG0020537	0	0	0	2	2
OG0020538	0	0	0	2	2
OG0020539	0	0	0	2	2
OG0020540	0	0	0	2	2
OG0020541	0	0	0	2	2
OG0020542	0	0	0	2	2
OG0020543	0	0	0	2	2
OG0020544	0	0	0	2	2
OG0020545	0	0	0	2	2
OG0020546	0	0	0	2	2
OG0020547	0	0	0	2	2
OG0020548	0	0	0	2	2
OG0020549	0	0	0	2	2
OG0020550	0	0	0	2	2
OG0020551	0	0	0	2	2
OG0020552	0	0	0	2	2
OG0020553	0	0	0	2	2
OG0020554	0	0	0	2	2
OG0020555	0	0	0	2	2
OG0020556	0	0	0	2	2
OG0020557	0	0	0	2	2
OG0020558	0	0	0	2	2
OG0020559	0	0	0	2	2
OG0020560	0	0	0	2	2
OG0020561	0	0	0	2	2
OG0020562	0	0	0	2	2
OG0020563	0	0	0	2	2
OG0020564	0	0	0	2	2
OG0020565	0	0	0	2	2
OG0020566	0	0	0	2	2
OG0020567	0	0	0	2	2
OG0020568	0	0	0	2	2
OG0020569	0	0	0	2	2
OG0020570	0	0	0	2	2
OG0020571	0	0	0	2	2
OG0020572	0	0	0	2	2
OG0020573	0	0	0	2	2
OG0020574	0	0	0	2	2
OG0020575	0	0	0	2	2
OG0020576	0	0	0	2	2
OG0020577	0	0	0	2	2
OG0020578	0	0	0	2	2
OG0020579	0	0	0	2	2
OG0020580	0	0	0	2	2
OG0020581	0	0	0	2	2
OG0020582	0	0	0	2	2
OG0020583	0	0	0	2	2
OG0020584	0	0	0	2	2
OG0020585	0	0	0	2	2
OG0020586	0	0	0	2	2
OG0020587	0	0	0	2	2
OG0020588	0	0	0	2	2
OG0020589	0	0	0	2	2
OG0020590	0	0	0	2	2
OG0020591	0	0	0	2	2
OG0020592	0	0	0	2	2
OG0020593	0	0	0	2	2
OG0020594	0	0	0	2	2
OG0020595	0	0	0	2	2
OG0020596	0	0	0	2	2
OG0020597	0	0	0	2	2
OG0020598	0	0	0	2	2
OG0020599	0	0	0	2	2
OG0020600	0	0	0	2	2
OG0020601	0	0	0	2	2
OG0020602	0	0	0	2	2
OG0020603	0	0	0	2	2
OG0020604	0	0	0	2	2
OG0020605	0	0	0	2	2
OG0020606	0	0	0	2	2
OG0020607	0	0	0	2	2
OG0020608	0	0	0	2	2
OG0020609	0	0	0	2	2
OG0020610	0	0	0	2	2
OG0020611	0	0	0	2	2
OG0020612	0	0	0	2	2
OG0020613	0	0	0	2	2
OG0020614	0	0	0	2	2
OG0020615	0	0	0	2	2
OG0020616	0	0	0	2	2
OG0020617	0	0	0	2	2
OG0020618	0	0	0	2	2
OG0020619	0	0	0	2	2
OG0020620	0	0	0	2	2
OG0020621	0	0	0	2	2
OG0020622	0	0	0	2	2
OG0020623	0	0	0	2	2
OG0020624	0	0	0	2	2
OG0020625	0	0	0	2	2
OG0020626	0	0	0	2	2
OG0020627	0	0	0	2	2
OG0020628	0	0	0	2	2
OG0020629	0	0	0	2	2
OG0020630	0	0	0	2	2
OG0020631	0	0	0	2	2
OG0020632	0	0	0	2	2
OG0020633	0	0	0	2	2
OG0020634	0	0	0	2	2
OG0020635	0	0	0	2	2
OG0020636	0	0	0	2	2
OG0020637	0	0	0	2	2
OG0020638	0	0	0	2	2
OG0020639	0	0	0	2	2
OG0020640	0	0	0	2	2
OG0020641	0	0	0	2	2
OG0020642	0	0	0	2	2
OG0020643	0	0	0	2	2
OG0020644	0	0	0	2	2
OG0020645	0	0	0	2	2
OG0020646	0	0	0	2	2
OG0020647	0	0	0	2	2
OG0020648	0	0	0	2	2
OG0020649	0	0	0	2	2
OG0020650	0	0	0	2	2
OG0020651	0	0	0	2	2
OG0020652	0	0	0	2	2
OG0020653	0	0	0	2	2
OG0020654	0	0	0	2	2
OG0020655	0	0	0	2	2
OG0020656	0	0	0	2	2
OG0020657	0	0	0	2	2
OG0020658	0	0	0	2	2
OG0020659	0	0	0	2	2
OG0020660	0	0	0	2	2
OG0020661	0	0	0	2	2
OG0020662	0	0	0	2	2
OG0020663	0	0	0	2	2
OG0020664	0	0	0	2	2
OG0020665	0	0	0	2	2
OG0020666	0	0	0	2	2
OG0020667	0	0	0	2	2
OG0020668	0	0	0	2	2
OG0020669	0	0	0	2	2
OG0020670	0	0	0	2	2
OG0020671	0	0	0	2	2
OG0020672	0	0	0	2	2
OG0020673	0	0	0	2	2
OG0020674	0	0	0	2	2
OG0020675	0	0	0	2	2
OG0020676	0	0	0	2	2
OG0020677	0	0	0	2	2
OG0020678	0	0	0	2	2
OG0020679	0	0	0	2	2
OG0020680	0	0	0	2	2
OG0020681	0	0	0	2	2
OG0020682	0	0	0	2	2
OG0020683	0	0	0	2	2
OG0020684	0	0	0	2	2
OG0020685	0	0	0	2	2
OG0020686	0	0	0	2	2
OG0020687	0	0	0	2	2
OG0020688	0	0	0	2	2
OG0020689	0	0	0	2	2
OG0020690	0	0	0	2	2
OG0020691	0	0	0	2	2
OG0020692	0	0	0	2	2
OG0020693	0	0	0	2	2
OG0020694	0	0	0	2	2
OG0020695	0	0	0	2	2
OG0020696	0	0	0	2	2
OG0020697	0	0	0	2	2
OG0020698	0	0	0	2	2
OG0020699	0	0	0	2	2
OG0020700	0	0	0	2	2
OG0020701	0	0	0	2	2
OG0020702	0	0	0	2	2
OG0020703	0	0	0	2	2
OG0020704	0	0	0	2	2
OG0020705	0	0	0	2	2
OG0020706	0	0	0	2	2
OG0020707	0	0	0	2	2
OG0020708	0	0	0	2	2
OG0020709	0	0	0	2	2
OG0020710	0	0	0	2	2
OG0020711	0	0	0	2	2
OG0020712	0	0	0	2	2
OG0020713	0	0	0	2	2
OG0020714	0	0	0	2	2
OG0020715	0	0	0	2	2
OG0020716	0	0	0	2	2
OG0020717	0	0	0	2	2
OG0020718	0	0	0	2	2
OG0020719	0	0	0	2	2
OG0020720	0	0	0	2	2
OG0020721	0	0	0	2	2
OG0020722	0	0	0	2	2
OG0020723	0	0	0	2	2
OG0020724	0	0	0	2	2
OG0020725	0	0	0	2	2
OG0020726	0	0	0	2	2
OG0020727	0	0	0	2	2
OG0020728	0	0	0	2	2
OG0020729	0	0	0	2	2
OG0020730	0	0	0	2	2
OG0020731	0	0	0	2	2
OG0020732	0	0	0	2	2
OG0020733	0	0	0	2	2
OG0020734	0	0	0	2	2
OG0020735	0	0	0	2	2
OG0020736	0	0	0	2	2
OG0020737	0	0	0	2	2
OG0020738	0	0	0	2	2
OG0020739	0	0	0	2	2
OG0020740	0	0	0	2	2
OG0020741	0	0	0	2	2
OG0020742	0	0	0	2	2
OG0020743	0	0	0	2	2
OG0020744	0	0	0	2	2
OG0020745	0	0	0	2	2
OG0020746	0	0	0	2	2
OG0020747	0	0	0	2	2
OG0020748	0	0	0	2	2
OG0020749	0	0	0	2	2
OG0020750	0	0	0	2	2
OG0020751	0	0	0	2	2
OG0020752	0	0	0	2	2
OG0020753	0	0	0	2	2
OG0020754	0	0	0	2	2
OG0020755	0	0	0	2	2
OG0020756	0	0	0	2	2
OG0020757	0	0	0	2	2
OG0020758	0	0	0	2	2
OG0020759	0	0	0	2	2
OG0020760	0	0	0	2	2
OG0020761	0	0	0	2	2
OG0020762	0	0	0	2	2
OG0020763	0	0	0	2	2
OG0020764	0	0	0	2	2
OG0020765	0	0	0	2	2
OG0020766	0	0	0	2	2
OG0020767	0	0	0	2	2
OG0020768	0	0	0	2	2
OG0020769	0	0	0	2	2
OG0020770	0	0	0	2	2
OG0020771	0	0	0	2	2
OG0020772	0	0	0	2	2
OG0020773	0	0	0	2	2
OG0020774	0	0	0	2	2
OG0020775	0	0	0	2	2
OG0020776	0	0	0	2	2
OG0020777	0	0	0	2	2
OG0020778	0	0	0	2	2
OG0020779	0	0	0	2	2
OG0020780	0	0	0	2	2
OG0020781	0	0	0	2	2
OG0020782	0	0	0	2	2
OG0020783	0	0	0	2	2
OG0020784	0	0	0	2	2
OG0020785	0	0	0	2	2
OG0020786	0	0	0	2	2
OG0020787	0	0	0	2	2
OG0020788	0	0	0	2	2
OG0020789	0	0	0	2	2
OG0020790	0	0	0	2	2
OG0020791	0	0	0	2	2
OG0020792	0	0	0	2	2
OG0020793	0	0	0	2	2
OG0020794	0	0	0	2	2
OG0020795	0	0	0	2	2
OG0020796	0	0	0	2	2
OG0020797	0	0	0	2	2
OG0020798	0	0	0	2	2
OG0020799	0	0	0	2	2
OG0020800	0	0	0	2	2
OG0020801	0	0	0	2	2
OG0020802	0	0	0	2	2
OG0020803	0	0	0	2	2
OG0020804	0	0	0	2	2
OG0020805	0	0	0	2	2
OG0020806	0	0	0	2	2
OG0020807	0	0	0	2	2
OG0020808	0	0	0	2	2
OG0020809	0	0	0	2	2
OG0020810	0	0	0	2	2
OG0020811	0	0	0	2	2
OG0020812	0	0	0	2	2
OG0020813	0	0	0	2	2
OG0020814	0	0	0	2	2
OG0020815	0	0	0	2	2
OG0020816	0	0	0	2	2
OG0020817	0	0	0	2	2
OG0020818	0	0	0	2	2
OG0020819	0	0	0	2	2
OG0020820	0	0	0	2	2
OG0020821	0	0	0	2	2
OG0020822	0	0	0	2	2
OG0020823	0	0	0	2	2
OG0020824	0	0	0	2	2
OG0020825	0	0	0	2	2
OG0020826	0	0	0	2	2
OG0020827	0	0	0	2	2
OG0020828	0	0	0	2	2
OG0020829	0	0	0	2	2
OG0020830	0	0	0	2	2
OG0020831	0	0	0	2	2
OG0020832	0	0	0	2	2
OG0020833	0	0	0	2	2
OG0020834	0	0	0	2	2
OG0020835	0	0	0	2	2
OG0020836	0	0	0	2	2
OG0020837	0	0	0	2	2
OG0020838	0	0	0	2	2
OG0020839	0	0	0	2	2
OG0020840	0	0	0	2	2
OG0020841	0	0	0	2	2
OG0020842	0	0	0	2	2
OG0020843	0	0	0	2	2
OG0020844	0	0	0	2	2
OG0020845	0	0	0	2	2
OG0020846	0	0	0	2	2
OG0020847	0	0	0	2	2
OG0020848	0	0	0	2	2
OG0020849	0	0	0	2	2
OG0020850	0	0	0	2	2
OG0020851	0	0	0	2	2
OG0020852	0	0	0	2	2
OG0020853	0	0	0	2	2
OG0020854	0	0	0	2	2
OG0020855	0	0	0	2	2
OG0020856	0	0	0	2	2
OG0020857	0	0	0	2	2
OG0020858	0	0	0	2	2
OG0020859	0	0	0	2	2
OG0020860	0	0	0	2	2
OG0020861	0	0	0	2	2
OG0020862	0	0	0	2	2
OG0020863	0	0	0	2	2
OG0020864	0	0	0	2	2
OG0020865	0	0	0	2	2
OG0020866	0	0	0	2	2
OG0020867	0	0	0	2	2
OG0020868	0	0	0	2	2
OG0020869	0	0	0	2	2
OG0020870	0	0	0	2	2
OG0020871	0	0	0	2	2
OG0020872	0	0	0	2	2
OG0020873	0	0	0	2	2
OG0020874	0	0	0	2	2
OG0020875	0	0	0	2	2
OG0020876	0	0	0	2	2
OG0020877	0	0	0	2	2
OG0020878	0	0	0	2	2
OG0020879	0	0	0	2	2
OG0020880	0	0	0	2	2
OG0020881	0	0	0	2	2
OG0020882	0	0	0	2	2
OG0020883	0	0	0	2	2
OG0020884	0	0	0	2	2
OG0020885	0	0	0	2	2
OG0020886	0	0	0	2	2
OG0020887	0	0	0	2	2
OG0020888	0	0	0	2	2
OG0020889	0	0	0	2	2
OG0020890	0	0	0	2	2
OG0020891	0	0	0	2	2
OG0020892	0	0	0	2	2
OG0020893	0	0	0	2	2
OG0020894	0	0	0	2	2
OG0020895	0	0	0	2	2
OG0020896	0	0	0	2	2
OG0020897	0	0	0	2	2
OG0020898	0	0	0	2	2
OG0020899	0	0	0	2	2
OG0020900	0	0	0	2	2
OG0020901	0	0	0	2	2
OG0020902	0	0	0	2	2
OG0020903	0	0	0	2	2
OG0020904	0	0	0	2	2
OG0020905	0	0	0	2	2
OG0020906	0	0	0	2	2
OG0020907	0	0	0	2	2
OG0020908	0	0	0	2	2
OG0020909	0	0	0	2	2
OG0020910	0	0	0	2	2
OG0020911	0	0	0	2	2
OG0020912	0	0	0	2	2
OG0020913	0	0	0	2	2
OG0020914	0	0	0	2	2
OG0020915	0	0	0	2	2
OG0020916	0	0	0	2	2
OG0020917	0	0	0	2	2
OG0020918	0	0	0	2	2
OG0020919	0	0	0	2	2
OG0020920	0	0	0	2	2
OG0020921	0	0	0	2	2
OG0020922	0	0	0	2	2
OG0020923	0	0	0	2	2
OG0020924	0	0	0	2	2
OG0020925	0	0	0	2	2
OG0020926	0	0	0	2	2
OG0020927	0	0	0	2	2
OG0020928	0	0	0	2	2
OG0020929	0	0	0	2	2
OG0020930	0	0	0	2	2
OG0020931	0	0	0	2	2
OG0020932	0	0	0	2	2
OG0020933	0	0	0	2	2
OG0020934	0	0	0	2	2
OG0020935	0	0	0	2	2
OG0020936	0	0	0	2	2
OG0020937	0	0	0	2	2
OG0020938	0	0	0	2	2
OG0020939	0	0	0	2	2
OG0020940	0	0	0	2	2
OG0020941	0	0	0	2	2
OG0020942	0	0	0	2	2
OG0020943	0	0	0	2	2
OG0020944	0	0	0	2	2
OG0020945	0	0	0	2	2
OG0020946	0	0	0	2	2
OG0020947	0	0	0	2	2
OG0020948	0	0	0	2	2
OG0020949	0	0	0	2	2
OG0020950	0	0	0	2	2
OG0020951	0	0	0	2	2
OG0020952	0	0	0	2	2
OG0020953	0	0	0	2	2
OG0020954	0	0	0	2	2
OG0020955	0	0	0	2	2
OG0020956	0	0	0	2	2
OG0020957	0	0	0	2	2
OG0020958	0	0	0	2	2
OG0020959	0	0	0	2	2
OG0020960	0	0	0	2	2
OG0020961	0	0	0	2	2
OG0020962	0	0	0	2	2
OG0020963	0	0	0	2	2
OG0020964	0	0	0	2	2
OG0020965	0	0	0	2	2
OG0020966	0	0	0	2	2
OG0020967	0	0	0	2	2
OG0020968	0	0	0	2	2
OG0020969	0	0	0	2	2
OG0020970	0	0	0	2	2
OG0020971	0	0	0	2	2
OG0020972	0	0	0	2	2
OG0020973	0	0	0	2	2
OG0020974	0	0	0	2	2
OG0020975	0	0	0	2	2
OG0020976	0	0	0	2	2
OG0020977	0	0	0	2	2
OG0020978	0	0	0	2	2
OG0020979	0	0	0	2	2
OG0020980	0	0	0	2	2
OG0020981	0	0	0	2	2
OG0020982	0	0	0	2	2
OG0020983	0	0	0	2	2
OG0020984	0	0	0	2	2
OG0020985	0	0	0	2	2
OG0020986	0	0	0	2	2
OG0020987	0	0	0	2	2
OG0020988	0	0	0	2	2
OG0020989	0	0	0	2	2
OG0020990	0	0	0	2	2
OG0020991	0	0	0	2	2
OG0020992	0	0	0	2	2
OG0020993	0	0	0	2	2
OG0020994	0	0	0	2	2
OG0020995	0	0	0	2	2
OG0020996	0	0	0	2	2
OG0020997	0	0	0	2	2
OG0020998	0	0	0	2	2
OG0020999	0	0	0	2	2
OG0021000	0	0	0	2	2
OG0021001	0	0	0	2	2
OG0021002	0	0	0	2	2
OG0021003	0	0	0	2	2
OG0021004	0	0	0	2	2
OG0021005	0	0	0	2	2
OG0021006	0	0	0	2	2
OG0021007	0	0	0	2	2
OG0021008	0	0	0	2	2
OG0021009	0	0	0	2	2
OG0021010	0	0	0	2	2
OG0021011	0	0	0	2	2
OG0021012	0	0	0	2	2
OG0021013	0	0	0	2	2
OG0021014	0	0	0	2	2
OG0021015	0	0	0	2	2
OG0021016	0	0	0	2	2
OG0021017	0	0	0	2	2
OG0021018	0	0	0	2	2
OG0021019	0	0	0	2	2
OG0021020	0	0	0	2	2
OG0021021	0	0	0	2	2
OG0021022	0	0	0	2	2
OG0021023	0	0	0	2	2
OG0021024	0	0	0	2	2
OG0021025	0	0	0	2	2
OG0021026	0	0	0	2	2
OG0021027	0	0	0	2	2
OG0021028	0	0	0	2	2
OG0021029	0	0	0	2	2
OG0021030	0	0	0	2	2
OG0021031	0	0	0	2	2
OG0021032	0	0	0	2	2
OG0021033	0	0	0	2	2
OG0021034	0	0	0	2	2
OG0021035	0	0	0	2	2
OG0021036	0	0	0	2	2
OG0021037	0	0	0	2	2
OG0021038	0	0	0	2	2
OG0021039	0	0	0	2	2
OG0021040	0	0	0	2	2
OG0021041	0	0	0	2	2
OG0021042	0	0	0	2	2
OG0021043	0	0	0	2	2
OG0021044	0	0	0	2	2
OG0021045	0	0	0	2	2
OG0021046	0	0	0	2	2
OG0021047	0	0	0	2	2
OG0021048	0	0	0	2	2
OG0021049	0	0	0	2	2
OG0021050	0	0	0	2	2
OG0021051	0	0	0	2	2
OG0021052	0	0	0	2	2
OG0021053	0	0	0	2	2
OG0021054	0	0	0	2	2
OG0021055	0	0	0	2	2
OG0021056	0	0	0	2	2
OG0021057	0	0	0	2	2
OG0021058	0	0	0	2	2
OG0021059	0	0	0	2	2
OG0021060	0	0	0	2	2
OG0021061	0	0	0	2	2
OG0021062	0	0	0	2	2
OG0021063	0	0	0	2	2
OG0021064	0	0	0	2	2
OG0021065	0	0	0	2	2
OG0021066	0	0	0	2	2
OG0021067	0	0	0	2	2
OG0021068	0	0	0	2	2
OG0021069	0	0	0	2	2
OG0021070	0	0	0	2	2
OG0021071	0	0	0	2	2
OG0021072	0	0	0	2	2
OG0021073	0	0	0	2	2
OG0021074	0	0	0	2	2
OG0021075	0	0	0	2	2
OG0021076	0	0	0	2	2
OG0021077	0	0	0	2	2
OG0021078	0	0	0	2	2
OG0021079	0	0	0	2	2
OG0021080	0	0	0	2	2
OG0021081	0	0	0	2	2
OG0021082	0	0	0	2	2
OG0021083	0	0	0	2	2
OG0021084	0	0	0	2	2
OG0021085	0	0	0	2	2
OG0021086	0	0	0	2	2
OG0021087	0	0	0	2	2
OG0021088	0	0	0	2	2
OG0021089	0	0	0	2	2
OG0021090	0	0	0	2	2
OG0021091	0	0	0	2	2
OG0021092	0	0	0	2	2
OG0021093	0	0	0	2	2
OG0021094	0	0	0	2	2
OG0021095	0	0	0	2	2
OG0021096	0	0	0	2	2
OG0021097	0	0	0	2	2
OG0021098	0	0	0	2	2
OG0021099	0	0	0	2	2
OG0021100	0	0	0	2	2
OG0021101	0	0	0	2	2
OG0021102	0	0	0	2	2
OG0021103	0	0	0	2	2
OG0021104	0	0	0	2	2
OG0021105	0	0	0	2	2
OG0021106	0	0	0	2	2
OG0021107	0	0	0	2	2
OG0021108	0	0	0	2	2
OG0021109	0	0	0	2	2
OG0021110	0	0	0	2	2
OG0021111	0	0	0	2	2
OG0021112	0	0	0	2	2
OG0021113	0	0	0	2	2
OG0021114	0	0	0	2	2
OG0021115	0	0	0	2	2
OG0021116	0	0	0	2	2
OG0021117	0	0	0	2	2
OG0021118	0	0	0	2	2
OG0021119	0	0	0	2	2
OG0021120	0	0	0	2	2
OG0021121	0	0	0	2	2
OG0021122	0	0	0	2	2
OG0021123	0	0	0	2	2
OG0021124	0	0	0	2	2
OG0021125	0	0	0	2	2
OG0021126	0	0	0	2	2
OG0021127	0	0	0	2	2
OG0021128	0	0	0	2	2
OG0021129	0	0	0	2	2
OG0021130	0	0	0	2	2
OG0021131	0	0	0	2	2
OG0021132	0	0	0	2	2
OG0021133	0	0	0	2	2
OG0021134	0	0	0	2	2
OG0021135	0	0	0	2	2
OG0021136	0	0	0	2	2
OG0021137	0	0	0	2	2
OG0021138	0	0	0	2	2
OG0021139	0	0	0	2	2
OG0021140	0	0	0	2	2
OG0021141	0	0	0	2	2
OG0021142	0	0	0	2	2
OG0021143	0	0	0	2	2
OG0021144	0	0	0	2	2
OG0021145	0	0	0	2	2
OG0021146	0	0	0	2	2
OG0021147	0	0	0	2	2
OG0021148	0	0	0	2	2
OG0021149	0	0	0	2	2
OG0021150	0	0	0	2	2
OG0021151	0	0	0	2	2
OG0021152	0	0	0	2	2
OG0021153	0	0	0	2	2
OG0021154	0	0	0	2	2
OG0021155	0	0	0	2	2
OG0021156	0	0	0	2	2
OG0021157	0	0	0	2	2
OG0021158	0	0	0	2	2
OG0021159	0	0	0	2	2
OG0021160	0	0	0	2	2
OG0021161	0	0	0	2	2
OG0021162	0	0	0	2	2
OG0021163	0	0	0	2	2
OG0021164	0	0	0	2	2
OG0021165	0	0	0	2	2
OG0021166	0	0	0	2	2
OG0021167	0	0	0	2	2
OG0021168	0	0	0	2	2
OG0021169	0	0	0	2	2
OG0021170	0	0	0	2	2
OG0021171	0	0	0	2	2
OG0021172	0	0	0	2	2
OG0021173	0	0	0	2	2
OG0021174	0	0	0	2	2
OG0021175	0	0	0	2	2
OG0021176	0	0	0	2	2
OG0021177	0	0	0	2	2
OG0021178	0	0	0	2	2
OG0021179	0	0	0	2	2
OG0021180	0	0	0	2	2
OG0021181	0	0	0	2	2
OG0021182	0	0	0	2	2
OG0021183	0	0	0	2	2
OG0021184	0	0	0	2	2
OG0021185	0	0	0	2	2
OG0021186	0	0	0	2	2
OG0021187	0	0	0	2	2
OG0021188	0	0	0	2	2
OG0021189	0	0	0	2	2
OG0021190	0	0	0	2	2
OG0021191	0	0	0	2	2
OG0021192	0	0	0	2	2
OG0021193	0	0	0	2	2
OG0021194	0	0	0	2	2
OG0021195	0	0	0	2	2
OG0021196	0	0	0	2	2
OG0021197	0	0	0	2	2
OG0021198	0	0	0	2	2
OG0021199	0	0	0	2	2
OG0021200	0	0	0	2	2
OG0021201	0	0	0	2	2
OG0021202	0	0	0	2	2
OG0021203	0	0	0	2	2
OG0021204	0	0	0	2	2
OG0021205	0	0	0	2	2
OG0021206	0	0	0	2	2
OG0021207	0	0	0	2	2
OG0021208	0	0	0	2	2
OG0021209	0	0	0	2	2
OG0021210	0	0	0	2	2
OG0021211	0	0	0	2	2
OG0021212	0	0	0	2	2
OG0021213	0	0	0	2	2
OG0021214	0	0	0	2	2
OG0021215	0	0	0	2	2
OG0021216	0	0	0	2	2
OG0021217	0	0	0	2	2
OG0021218	0	0	0	2	2
OG0021219	0	0	0	2	2
OG0021220	0	0	0	2	2
OG0021221	0	0	0	2	2
OG0021222	0	0	0	2	2
OG0021223	0	0	0	2	2
OG0021224	0	0	0	2	2
OG0021225	0	0	0	2	2
OG0021226	0	0	0	2	2
OG0021227	0	0	0	2	2
OG0021228	0	0	0	2	2
